組別,分數區間均數,人數,百分比,累計人數,累計百分比
1,298.5,0,0,0,0
1,295.5,0,0,0,0
1,292.5,0,0,0,0
1,289.5,0,0,0,0
1,286.5,0,0,0,0
1,283.5,0,0,0,0
1,280.5,2,0.01,2,0.01
1,277.5,10,0.04,12,0.05
1,274.5,8,0.03,20,0.08
1,271.5,19,0.08,39,0.16
1,268.5,22,0.09,61,0.26
1,265.5,44,0.19,105,0.44
1,262.5,56,0.24,161,0.68
1,259.5,63,0.27,224,0.94
1,256.5,93,0.39,317,1.34
1,253.5,127,0.54,444,1.87
1,250.5,132,0.56,576,2.43
1,247.5,159,0.67,735,3.1
1,244.5,180,0.76,915,3.86
1,241.5,243,1.02,1158,4.88
1,238.5,228,0.96,1386,5.84
1,235.5,264,1.11,1650,6.96
1,232.5,300,1.26,1950,8.22
1,229.5,288,1.21,2238,9.44
1,226.5,323,1.36,2561,10.8
1,223.5,340,1.43,2901,12.23
1,220.5,364,1.53,3265,13.77
1,217.5,367,1.55,3632,15.31
1,214.5,344,1.45,3976,16.76
1,211.5,386,1.63,4362,18.39
1,208.5,392,1.65,4754,20.04
1,205.5,405,1.71,5159,21.75
1,202.5,431,1.82,5590,23.57
1,199.5,425,1.79,6015,25.36
1,196.5,395,1.67,6410,27.02
1,193.5,405,1.71,6815,28.73
1,190.5,484,2.04,7299,30.77
1,187.5,446,1.88,7745,32.65
1,184.5,479,2.02,8224,34.67
1,181.5,413,1.74,8637,36.41
1,178.5,452,1.91,9089,38.32
1,175.5,448,1.89,9537,40.21
1,172.5,472,1.99,10009,42.2
1,169.5,437,1.84,10446,44.04
1,166.5,439,1.85,10885,45.89
1,163.5,445,1.88,11330,47.77
1,160.5,457,1.93,11787,49.69
1,157.5,450,1.9,12237,51.59
1,154.5,421,1.77,12658,53.37
1,151.5,454,1.91,13112,55.28
1,148.5,457,1.93,13569,57.21
1,145.5,464,1.96,14033,59.16
1,142.5,517,2.18,14550,61.34
1,139.5,459,1.94,15009,63.28
1,136.5,444,1.87,15453,65.15
1,133.5,441,1.86,15894,67.01
1,130.5,420,1.77,16314,68.78
1,127.5,451,1.9,16765,70.68
1,124.5,436,1.84,17201,72.52
1,121.5,418,1.76,17619,74.28
1,118.5,415,1.75,18034,76.03
1,115.5,398,1.68,18432,77.71
1,112.5,382,1.61,18814,79.32
1,109.5,310,1.31,19124,80.63
1,106.5,344,1.45,19468,82.08
1,103.5,328,1.38,19796,83.46
1,100.5,324,1.37,20120,84.83
1,97.5,259,1.09,20379,85.92
1,94.5,267,1.13,20646,87.04
1,91.5,207,0.87,20853,87.92
1,88.5,231,0.97,21084,88.89
1,85.5,218,0.92,21302,89.81
1,82.5,182,0.77,21484,90.58
1,79.5,168,0.71,21652,91.29
1,76.5,147,0.62,21799,91.91
1,73.5,133,0.56,21932,92.47
1,70.5,122,0.51,22054,92.98
1,67.5,112,0.47,22166,93.45
1,64.5,105,0.44,22271,93.9
1,61.5,93,0.39,22364,94.29
1,58.5,64,0.27,22428,94.56
1,55.5,72,0.3,22500,94.86
1,52.5,52,0.22,22552,95.08
1,49.5,33,0.14,22585,95.22
1,46.5,33,0.14,22618,95.36
1,43.5,22,0.09,22640,95.45
1,40.5,16,0.07,22656,95.52
1,37.5,17,0.07,22673,95.59
1,34.5,9,0.04,22682,95.63
1,31.5,6,0.03,22688,95.65
1,28.5,9,0.04,22697,95.69
1,25.5,9,0.04,22706,95.73
1,22.5,13,0.05,22719,95.78
1,19.5,10,0.04,22729,95.83
1,16.5,15,0.06,22744,95.89
1,13.5,11,0.05,22755,95.94
1,10.5,5,0.02,22760,95.96
1,7.5,15,0.06,22775,96.02
1,4.5,8,0.03,22783,96.05
1,1.5,936,3.95,23719,100
2,298.5,0,0,0,0
2,295.5,0,0,0,0
2,292.5,0,0,0,0
2,289.5,1,0,1,0
2,286.5,3,0.01,4,0.02
2,283.5,6,0.03,10,0.05
2,280.5,13,0.06,23,0.11
2,277.5,16,0.07,39,0.18
2,274.5,20,0.09,59,0.28
2,271.5,25,0.12,84,0.39
2,268.5,37,0.17,121,0.57
2,265.5,69,0.32,190,0.89
2,262.5,66,0.31,256,1.2
2,259.5,80,0.37,336,1.57
2,256.5,89,0.42,425,1.98
2,253.5,103,0.48,528,2.47
2,250.5,121,0.57,649,3.03
2,247.5,132,0.62,781,3.65
2,244.5,172,0.8,953,4.45
2,241.5,180,0.84,1133,5.29
2,238.5,152,0.71,1285,6
2,235.5,210,0.98,1495,6.98
2,232.5,214,1,1709,7.98
2,229.5,232,1.08,1941,9.06
2,226.5,221,1.03,2162,10.1
2,223.5,237,1.11,2399,11.2
2,220.5,264,1.23,2663,12.44
2,217.5,271,1.27,2934,13.7
2,214.5,308,1.44,3242,15.14
2,211.5,295,1.38,3537,16.52
2,208.5,281,1.31,3818,17.83
2,205.5,298,1.39,4116,19.22
2,202.5,323,1.51,4439,20.73
2,199.5,306,1.43,4745,22.16
2,196.5,337,1.57,5082,23.73
2,193.5,318,1.49,5400,25.22
2,190.5,338,1.58,5738,26.8
2,187.5,396,1.85,6134,28.64
2,184.5,341,1.59,6475,30.24
2,181.5,358,1.67,6833,31.91
2,178.5,326,1.52,7159,33.43
2,175.5,351,1.64,7510,35.07
2,172.5,350,1.63,7860,36.7
2,169.5,366,1.71,8226,38.41
2,166.5,373,1.74,8599,40.16
2,163.5,358,1.67,8957,41.83
2,160.5,381,1.78,9338,43.61
2,157.5,337,1.57,9675,45.18
2,154.5,379,1.77,10054,46.95
2,151.5,371,1.73,10425,48.68
2,148.5,327,1.53,10752,50.21
2,145.5,368,1.72,11120,51.93
2,142.5,375,1.75,11495,53.68
2,139.5,323,1.51,11818,55.19
2,136.5,371,1.73,12189,56.92
2,133.5,355,1.66,12544,58.58
2,130.5,359,1.68,12903,60.25
2,127.5,313,1.46,13216,61.72
2,124.5,336,1.57,13552,63.29
2,121.5,287,1.34,13839,64.63
2,118.5,335,1.56,14174,66.19
2,115.5,336,1.57,14510,67.76
2,112.5,331,1.55,14841,69.31
2,109.5,336,1.57,15177,70.87
2,106.5,328,1.53,15505,72.41
2,103.5,343,1.6,15848,74.01
2,100.5,333,1.56,16181,75.56
2,97.5,318,1.49,16499,77.05
2,94.5,330,1.54,16829,78.59
2,91.5,277,1.29,17106,79.88
2,88.5,293,1.37,17399,81.25
2,85.5,281,1.31,17680,82.56
2,82.5,257,1.2,17937,83.76
2,79.5,261,1.22,18198,84.98
2,76.5,273,1.27,18471,86.26
2,73.5,267,1.25,18738,87.5
2,70.5,258,1.2,18996,88.71
2,67.5,225,1.05,19221,89.76
2,64.5,178,0.83,19399,90.59
2,61.5,203,0.95,19602,91.54
2,58.5,165,0.77,19767,92.31
2,55.5,162,0.76,19929,93.07
2,52.5,139,0.65,20068,93.71
2,49.5,114,0.53,20182,94.25
2,46.5,85,0.4,20267,94.64
2,43.5,84,0.39,20351,95.04
2,40.5,47,0.22,20398,95.26
2,37.5,37,0.17,20435,95.43
2,34.5,22,0.1,20457,95.53
2,31.5,23,0.11,20480,95.64
2,28.5,12,0.06,20492,95.69
2,25.5,8,0.04,20500,95.73
2,22.5,11,0.05,20511,95.78
2,19.5,6,0.03,20517,95.81
2,16.5,3,0.01,20520,95.83
2,13.5,6,0.03,20526,95.85
2,10.5,7,0.03,20533,95.89
2,7.5,0,0,20533,95.89
2,4.5,1,0,20534,95.89
2,1.5,880,4.11,21414,100
3,298.5,0,0,0,0
3,295.5,0,0,0,0
3,292.5,0,0,0,0
3,289.5,0,0,0,0
3,286.5,2,0.01,2,0.01
3,283.5,10,0.06,12,0.08
3,280.5,16,0.1,28,0.18
3,277.5,22,0.14,50,0.32
3,274.5,44,0.28,94,0.61
3,271.5,71,0.46,165,1.07
3,268.5,100,0.65,265,1.71
3,265.5,133,0.86,398,2.57
3,262.5,175,1.13,573,3.7
3,259.5,209,1.35,782,5.05
3,256.5,230,1.49,1012,6.54
3,253.5,218,1.41,1230,7.94
3,250.5,263,1.7,1493,9.64
3,247.5,278,1.8,1771,11.44
3,244.5,275,1.78,2046,13.21
3,241.5,287,1.85,2333,15.07
3,238.5,276,1.78,2609,16.85
3,235.5,292,1.89,2901,18.74
3,232.5,267,1.72,3168,20.46
3,229.5,277,1.79,3445,22.25
3,226.5,256,1.65,3701,23.9
3,223.5,232,1.5,3933,25.4
3,220.5,241,1.56,4174,26.96
3,217.5,270,1.74,4444,28.7
3,214.5,265,1.71,4709,30.41
3,211.5,280,1.81,4989,32.22
3,208.5,239,1.54,5228,33.77
3,205.5,230,1.49,5458,35.25
3,202.5,216,1.4,5674,36.65
3,199.5,227,1.47,5901,38.11
3,196.5,251,1.62,6152,39.73
3,193.5,252,1.63,6404,41.36
3,190.5,221,1.43,6625,42.79
3,187.5,238,1.54,6863,44.33
3,184.5,222,1.43,7085,45.76
3,181.5,238,1.54,7323,47.3
3,178.5,220,1.42,7543,48.72
3,175.5,215,1.39,7758,50.11
3,172.5,233,1.5,7991,51.61
3,169.5,223,1.44,8214,53.05
3,166.5,209,1.35,8423,54.4
3,163.5,225,1.45,8648,55.85
3,160.5,227,1.47,8875,57.32
3,157.5,215,1.39,9090,58.71
3,154.5,219,1.41,9309,60.12
3,151.5,228,1.47,9537,61.6
3,148.5,229,1.48,9766,63.08
3,145.5,217,1.4,9983,64.48
3,142.5,210,1.36,10193,65.83
3,139.5,181,1.17,10374,67
3,136.5,185,1.19,10559,68.2
3,133.5,162,1.05,10721,69.24
3,130.5,190,1.23,10911,70.47
3,127.5,195,1.26,11106,71.73
3,124.5,197,1.27,11303,73
3,121.5,190,1.23,11493,74.23
3,118.5,174,1.12,11667,75.35
3,115.5,192,1.24,11859,76.59
3,112.5,184,1.19,12043,77.78
3,109.5,166,1.07,12209,78.85
3,106.5,166,1.07,12375,79.93
3,103.5,159,1.03,12534,80.95
3,100.5,148,0.96,12682,81.91
3,97.5,168,1.09,12850,82.99
3,94.5,151,0.98,13001,83.97
3,91.5,178,1.15,13179,85.12
3,88.5,152,0.98,13331,86.1
3,85.5,169,1.09,13500,87.19
3,82.5,130,0.84,13630,88.03
3,79.5,115,0.74,13745,88.77
3,76.5,117,0.76,13862,89.53
3,73.5,121,0.78,13983,90.31
3,70.5,112,0.72,14095,91.04
3,67.5,108,0.7,14203,91.73
3,64.5,89,0.57,14292,92.31
3,61.5,82,0.53,14374,92.84
3,58.5,94,0.61,14468,93.44
3,55.5,52,0.34,14520,93.78
3,52.5,52,0.34,14572,94.12
3,49.5,43,0.28,14615,94.39
3,46.5,33,0.21,14648,94.61
3,43.5,23,0.15,14671,94.76
3,40.5,21,0.14,14692,94.89
3,37.5,19,0.12,14711,95.01
3,34.5,15,0.1,14726,95.11
3,31.5,9,0.06,14735,95.17
3,28.5,12,0.08,14747,95.25
3,25.5,6,0.04,14753,95.29
3,22.5,7,0.05,14760,95.33
3,19.5,5,0.03,14765,95.36
3,16.5,6,0.04,14771,95.4
3,13.5,3,0.02,14774,95.42
3,10.5,3,0.02,14777,95.44
3,7.5,1,0.01,14778,95.45
3,4.5,0,0,14778,95.45
3,1.5,705,4.55,15483,100
4,298.5,0,0,0,0
4,295.5,0,0,0,0
4,292.5,0,0,0,0
4,289.5,0,0,0,0
4,286.5,2,0.01,2,0.01
4,283.5,9,0.04,11,0.05
4,280.5,19,0.09,30,0.14
4,277.5,22,0.1,52,0.24
4,274.5,34,0.16,86,0.4
4,271.5,66,0.31,152,0.71
4,268.5,82,0.38,234,1.09
4,265.5,92,0.43,326,1.52
4,262.5,129,0.6,455,2.12
4,259.5,143,0.66,598,2.78
4,256.5,171,0.79,769,3.57
4,253.5,194,0.9,963,4.48
4,250.5,237,1.1,1200,5.58
4,247.5,241,1.12,1441,6.7
4,244.5,246,1.14,1687,7.84
4,241.5,289,1.34,1976,9.19
4,238.5,283,1.32,2259,10.5
4,235.5,318,1.48,2577,11.98
4,232.5,295,1.37,2872,13.35
4,229.5,311,1.45,3183,14.8
4,226.5,340,1.58,3523,16.38
4,223.5,294,1.37,3817,17.74
4,220.5,332,1.54,4149,19.29
4,217.5,326,1.52,4475,20.8
4,214.5,368,1.71,4843,22.51
4,211.5,330,1.53,5173,24.05
4,208.5,316,1.47,5489,25.52
4,205.5,319,1.48,5808,27
4,202.5,340,1.58,6148,28.58
4,199.5,340,1.58,6488,30.16
4,196.5,352,1.64,6840,31.8
4,193.5,356,1.65,7196,33.45
4,190.5,347,1.61,7543,35.07
4,187.5,365,1.7,7908,36.76
4,184.5,383,1.78,8291,38.54
4,181.5,325,1.51,8616,40.05
4,178.5,362,1.68,8978,41.74
4,175.5,337,1.57,9315,43.3
4,172.5,346,1.61,9661,44.91
4,169.5,376,1.75,10037,46.66
4,166.5,358,1.66,10395,48.32
4,163.5,354,1.65,10749,49.97
4,160.5,349,1.62,11098,51.59
4,157.5,337,1.57,11435,53.16
4,154.5,319,1.48,11754,54.64
4,151.5,334,1.55,12088,56.19
4,148.5,313,1.46,12401,57.65
4,145.5,319,1.48,12720,59.13
4,142.5,308,1.43,13028,60.56
4,139.5,309,1.44,13337,62
4,136.5,293,1.36,13630,63.36
4,133.5,319,1.48,13949,64.85
4,130.5,282,1.31,14231,66.16
4,127.5,283,1.32,14514,67.47
4,124.5,304,1.41,14818,68.89
4,121.5,266,1.24,15084,70.12
4,118.5,293,1.36,15377,71.48
4,115.5,285,1.32,15662,72.81
4,112.5,302,1.4,15964,74.21
4,109.5,340,1.58,16304,75.79
4,106.5,278,1.29,16582,77.09
4,103.5,269,1.25,16851,78.34
4,100.5,272,1.26,17123,79.6
4,97.5,278,1.29,17401,80.89
4,94.5,288,1.34,17689,82.23
4,91.5,241,1.12,17930,83.35
4,88.5,311,1.45,18241,84.8
4,85.5,278,1.29,18519,86.09
4,82.5,213,0.99,18732,87.08
4,79.5,248,1.15,18980,88.23
4,76.5,254,1.18,19234,89.41
4,73.5,233,1.08,19467,90.5
4,70.5,183,0.85,19650,91.35
4,67.5,189,0.88,19839,92.23
4,64.5,152,0.71,19991,92.93
4,61.5,145,0.67,20136,93.61
4,58.5,132,0.61,20268,94.22
4,55.5,85,0.4,20353,94.62
4,52.5,82,0.38,20435,95
4,49.5,60,0.28,20495,95.28
4,46.5,36,0.17,20531,95.44
4,43.5,30,0.14,20561,95.58
4,40.5,29,0.13,20590,95.72
4,37.5,18,0.08,20608,95.8
4,34.5,11,0.05,20619,95.85
4,31.5,10,0.05,20629,95.9
4,28.5,9,0.04,20638,95.94
4,25.5,7,0.03,20645,95.97
4,22.5,10,0.05,20655,96.02
4,19.5,10,0.05,20665,96.07
4,16.5,5,0.02,20670,96.09
4,13.5,4,0.02,20674,96.11
4,10.5,3,0.01,20677,96.12
4,7.5,1,0,20678,96.13
4,4.5,0,0,20678,96.13
4,1.5,833,3.87,21511,100
5,398,0,0,0,0
5,394,0,0,0,0
5,390,0,0,0,0
5,386,0,0,0,0
5,382,0,0,0,0
5,378,4,0.03,4,0.03
5,374,9,0.07,13,0.09
5,370,20,0.15,33,0.24
5,366,27,0.2,60,0.44
5,362,36,0.26,96,0.7
5,358,74,0.54,170,1.24
5,354,100,0.73,270,1.96
5,350,116,0.84,386,2.81
5,346,130,0.95,516,3.75
5,342,158,1.15,674,4.9
5,338,169,1.23,843,6.13
5,334,217,1.58,1060,7.71
5,330,192,1.4,1252,9.1
5,326,219,1.59,1471,10.7
5,322,247,1.8,1718,12.49
5,318,250,1.82,1968,14.31
5,314,243,1.77,2211,16.08
5,310,218,1.59,2429,17.66
5,306,248,1.8,2677,19.47
5,302,213,1.55,2890,21.02
5,298,234,1.7,3124,22.72
5,294,223,1.62,3347,24.34
5,290,244,1.77,3591,26.11
5,286,226,1.64,3817,27.76
5,282,200,1.45,4017,29.21
5,278,231,1.68,4248,30.89
5,274,216,1.57,4464,32.46
5,270,210,1.53,4674,33.99
5,266,229,1.67,4903,35.65
5,262,217,1.58,5120,37.23
5,258,220,1.6,5340,38.83
5,254,196,1.43,5536,40.26
5,250,226,1.64,5762,41.9
5,246,217,1.58,5979,43.48
5,242,221,1.61,6200,45.08
5,238,223,1.62,6423,46.71
5,234,222,1.61,6645,48.32
5,230,203,1.48,6848,49.8
5,226,219,1.59,7067,51.39
5,222,222,1.61,7289,53
5,218,221,1.61,7510,54.61
5,214,226,1.64,7736,56.25
5,210,197,1.43,7933,57.69
5,206,213,1.55,8146,59.24
5,202,233,1.69,8379,60.93
5,198,203,1.48,8582,62.41
5,194,193,1.4,8775,63.81
5,190,192,1.4,8967,65.21
5,186,176,1.28,9143,66.48
5,182,176,1.28,9319,67.76
5,178,169,1.23,9488,68.99
5,174,160,1.16,9648,70.16
5,170,160,1.16,9808,71.32
5,166,178,1.29,9986,72.61
5,162,177,1.29,10163,73.9
5,158,162,1.18,10325,75.08
5,154,186,1.35,10511,76.43
5,150,179,1.3,10690,77.73
5,146,174,1.27,10864,79
5,142,171,1.24,11035,80.24
5,138,170,1.24,11205,81.48
5,134,152,1.11,11357,82.58
5,130,155,1.13,11512,83.71
5,126,137,1,11649,84.71
5,122,137,1,11786,85.7
5,118,127,0.92,11913,86.63
5,114,144,1.05,12057,87.67
5,110,124,0.9,12181,88.58
5,106,128,0.93,12309,89.51
5,102,94,0.68,12403,90.19
5,98,101,0.73,12504,90.92
5,94,98,0.71,12602,91.64
5,90,82,0.6,12684,92.23
5,86,72,0.52,12756,92.76
5,82,78,0.57,12834,93.32
5,78,61,0.44,12895,93.77
5,74,54,0.39,12949,94.16
5,70,37,0.27,12986,94.43
5,66,35,0.25,13021,94.68
5,62,30,0.22,13051,94.9
5,58,20,0.15,13071,95.05
5,54,11,0.08,13082,95.13
5,50,6,0.04,13088,95.17
5,46,6,0.04,13094,95.22
5,42,7,0.05,13101,95.27
5,38,6,0.04,13107,95.31
5,34,7,0.05,13114,95.36
5,30,6,0.04,13120,95.4
5,26,7,0.05,13127,95.46
5,22,9,0.07,13136,95.52
5,18,7,0.05,13143,95.57
5,14,3,0.02,13146,95.59
5,10,4,0.03,13150,95.62
5,6,0,0,13150,95.62
5,2,602,4.38,13752,100
6,298.5,0,0,0,0
6,295.5,0,0,0,0
6,292.5,0,0,0,0
6,289.5,0,0,0,0
6,286.5,0,0,0,0
6,283.5,0,0,0,0
6,280.5,2,0.01,2,0.01
6,277.5,2,0.01,4,0.02
6,274.5,4,0.02,8,0.04
6,271.5,11,0.05,19,0.08
6,268.5,21,0.09,40,0.18
6,265.5,24,0.11,64,0.28
6,262.5,47,0.21,111,0.49
6,259.5,61,0.27,172,0.76
6,256.5,72,0.32,244,1.08
6,253.5,103,0.46,347,1.54
6,250.5,128,0.57,475,2.11
6,247.5,161,0.72,636,2.83
6,244.5,204,0.91,840,3.73
6,241.5,225,1,1065,4.73
6,238.5,259,1.15,1324,5.88
6,235.5,291,1.29,1615,7.17
6,232.5,329,1.46,1944,8.64
6,229.5,367,1.63,2311,10.27
6,226.5,392,1.74,2703,12.01
6,223.5,348,1.55,3051,13.55
6,220.5,392,1.74,3443,15.29
6,217.5,373,1.66,3816,16.95
6,214.5,442,1.96,4258,18.91
6,211.5,405,1.8,4663,20.71
6,208.5,433,1.92,5096,22.64
6,205.5,396,1.76,5492,24.4
6,202.5,401,1.78,5893,26.18
6,199.5,444,1.97,6337,28.15
6,196.5,457,2.03,6794,30.18
6,193.5,426,1.89,7220,32.07
6,190.5,471,2.09,7691,34.16
6,187.5,444,1.97,8135,36.14
6,184.5,416,1.85,8551,37.98
6,181.5,423,1.88,8974,39.86
6,178.5,441,1.96,9415,41.82
6,175.5,469,2.08,9884,43.91
6,172.5,446,1.98,10330,45.89
6,169.5,428,1.9,10758,47.79
6,166.5,492,2.19,11250,49.97
6,163.5,455,2.02,11705,51.99
6,160.5,484,2.15,12189,54.14
6,157.5,504,2.24,12693,56.38
6,154.5,462,2.05,13155,58.44
6,151.5,482,2.14,13637,60.58
6,148.5,471,2.09,14108,62.67
6,145.5,468,2.08,14576,64.75
6,142.5,479,2.13,15055,66.88
6,139.5,470,2.09,15525,68.96
6,136.5,470,2.09,15995,71.05
6,133.5,467,2.07,16462,73.13
6,130.5,423,1.88,16885,75
6,127.5,424,1.88,17309,76.89
6,124.5,414,1.84,17723,78.73
6,121.5,376,1.67,18099,80.4
6,118.5,362,1.61,18461,82.01
6,115.5,327,1.45,18788,83.46
6,112.5,311,1.38,19099,84.84
6,109.5,290,1.29,19389,86.13
6,106.5,275,1.22,19664,87.35
6,103.5,242,1.07,19906,88.42
6,100.5,219,0.97,20125,89.4
6,97.5,170,0.76,20295,90.15
6,94.5,164,0.73,20459,90.88
6,91.5,155,0.69,20614,91.57
6,88.5,153,0.68,20767,92.25
6,85.5,118,0.52,20885,92.77
6,82.5,109,0.48,20994,93.26
6,79.5,83,0.37,21077,93.63
6,76.5,89,0.4,21166,94.02
6,73.5,72,0.32,21238,94.34
6,70.5,68,0.3,21306,94.64
6,67.5,44,0.2,21350,94.84
6,64.5,45,0.2,21395,95.04
6,61.5,26,0.12,21421,95.15
6,58.5,32,0.14,21453,95.3
6,55.5,19,0.08,21472,95.38
6,52.5,24,0.11,21496,95.49
6,49.5,17,0.08,21513,95.56
6,46.5,9,0.04,21522,95.6
6,43.5,7,0.03,21529,95.63
6,40.5,8,0.04,21537,95.67
6,37.5,7,0.03,21544,95.7
6,34.5,12,0.05,21556,95.75
6,31.5,3,0.01,21559,95.77
6,28.5,8,0.04,21567,95.8
6,25.5,13,0.06,21580,95.86
6,22.5,8,0.04,21588,95.9
6,19.5,11,0.05,21599,95.94
6,16.5,19,0.08,21618,96.03
6,13.5,11,0.05,21629,96.08
6,10.5,5,0.02,21634,96.1
6,7.5,5,0.02,21639,96.12
6,4.5,1,0,21640,96.13
6,1.5,872,3.87,22512,100
7,298.5,0,0,0,0
7,295.5,0,0,0,0
7,292.5,0,0,0,0
7,289.5,0,0,0,0
7,286.5,0,0,0,0
7,283.5,0,0,0,0
7,280.5,0,0,0,0
7,277.5,3,0.01,3,0.01
7,274.5,0,0,3,0.01
7,271.5,12,0.05,15,0.06
7,268.5,10,0.04,25,0.1
7,265.5,21,0.09,46,0.19
7,262.5,33,0.13,79,0.32
7,259.5,45,0.18,124,0.51
7,256.5,62,0.25,186,0.76
7,253.5,93,0.38,279,1.14
7,250.5,114,0.47,393,1.61
7,247.5,160,0.65,553,2.26
7,244.5,160,0.65,713,2.91
7,241.5,233,0.95,946,3.86
7,238.5,204,0.83,1150,4.7
7,235.5,248,1.01,1398,5.71
7,232.5,269,1.1,1667,6.81
7,229.5,314,1.28,1981,8.09
7,226.5,344,1.41,2325,9.5
7,223.5,327,1.34,2652,10.83
7,220.5,406,1.66,3058,12.49
7,217.5,401,1.64,3459,14.13
7,214.5,384,1.57,3843,15.7
7,211.5,412,1.68,4255,17.38
7,208.5,410,1.67,4665,19.06
7,205.5,407,1.66,5072,20.72
7,202.5,414,1.69,5486,22.41
7,199.5,407,1.66,5893,24.07
7,196.5,441,1.8,6334,25.88
7,193.5,469,1.92,6803,27.79
7,190.5,432,1.76,7235,29.56
7,187.5,468,1.91,7703,31.47
7,184.5,441,1.8,8144,33.27
7,181.5,446,1.82,8590,35.09
7,178.5,473,1.93,9063,37.03
7,175.5,411,1.68,9474,38.7
7,172.5,476,1.94,9950,40.65
7,169.5,485,1.98,10435,42.63
7,166.5,453,1.85,10888,44.48
7,163.5,480,1.96,11368,46.44
7,160.5,451,1.84,11819,48.28
7,157.5,460,1.88,12279,50.16
7,154.5,519,2.12,12798,52.28
7,151.5,484,1.98,13282,54.26
7,148.5,494,2.02,13776,56.28
7,145.5,501,2.05,14277,58.33
7,142.5,508,2.08,14785,60.4
7,139.5,488,1.99,15273,62.39
7,136.5,472,1.93,15745,64.32
7,133.5,489,2,16234,66.32
7,130.5,433,1.77,16667,68.09
7,127.5,453,1.85,17120,69.94
7,124.5,472,1.93,17592,71.87
7,121.5,423,1.73,18015,73.6
7,118.5,473,1.93,18488,75.53
7,115.5,456,1.86,18944,77.39
7,112.5,432,1.76,19376,79.16
7,109.5,384,1.57,19760,80.73
7,106.5,378,1.54,20138,82.27
7,103.5,370,1.51,20508,83.78
7,100.5,333,1.36,20841,85.14
7,97.5,298,1.22,21139,86.36
7,94.5,295,1.21,21434,87.56
7,91.5,230,0.94,21664,88.5
7,88.5,226,0.92,21890,89.43
7,85.5,225,0.92,22115,90.35
7,82.5,182,0.74,22297,91.09
7,79.5,181,0.74,22478,91.83
7,76.5,177,0.72,22655,92.55
7,73.5,129,0.53,22784,93.08
7,70.5,128,0.52,22912,93.6
7,67.5,108,0.44,23020,94.04
7,64.5,75,0.31,23095,94.35
7,61.5,86,0.35,23181,94.7
7,58.5,56,0.23,23237,94.93
7,55.5,44,0.18,23281,95.11
7,52.5,40,0.16,23321,95.27
7,49.5,27,0.11,23348,95.38
7,46.5,12,0.05,23360,95.43
7,43.5,22,0.09,23382,95.52
7,40.5,13,0.05,23395,95.58
7,37.5,8,0.03,23403,95.61
7,34.5,12,0.05,23415,95.66
7,31.5,6,0.02,23421,95.68
7,28.5,8,0.03,23429,95.71
7,25.5,17,0.07,23446,95.78
7,22.5,9,0.04,23455,95.82
7,19.5,16,0.07,23471,95.89
7,16.5,19,0.08,23490,95.96
7,13.5,13,0.05,23503,96.02
7,10.5,8,0.03,23511,96.05
7,7.5,4,0.02,23515,96.07
7,4.5,1,0,23516,96.07
7,1.5,962,3.93,24478,100
8,398,0,0,0,0
8,394,0,0,0,0
8,390,0,0,0,0
8,386,0,0,0,0
8,382,0,0,0,0
8,378,0,0,0,0
8,374,1,0,1,0
8,370,3,0.01,4,0.02
8,366,2,0.01,6,0.03
8,362,9,0.04,15,0.07
8,358,14,0.06,29,0.13
8,354,20,0.09,49,0.23
8,350,36,0.17,85,0.39
8,346,49,0.23,134,0.62
8,342,66,0.31,200,0.93
8,338,104,0.48,304,1.41
8,334,106,0.49,410,1.9
8,330,142,0.66,552,2.56
8,326,179,0.83,731,3.39
8,322,205,0.95,936,4.34
8,318,246,1.14,1182,5.49
8,314,269,1.25,1451,6.73
8,310,301,1.4,1752,8.13
8,306,344,1.6,2096,9.73
8,302,335,1.55,2431,11.28
8,298,367,1.7,2798,12.99
8,294,341,1.58,3139,14.57
8,290,392,1.82,3531,16.39
8,286,402,1.87,3933,18.25
8,282,383,1.78,4316,20.03
8,278,384,1.78,4700,21.81
8,274,401,1.86,5101,23.67
8,270,394,1.83,5495,25.5
8,266,470,2.18,5965,27.68
8,262,441,2.05,6406,29.73
8,258,462,2.14,6868,31.88
8,254,438,2.03,7306,33.91
8,250,434,2.01,7740,35.92
8,246,448,2.08,8188,38
8,242,459,2.13,8647,40.13
8,238,439,2.04,9086,42.17
8,234,457,2.12,9543,44.29
8,230,465,2.16,10008,46.45
8,226,466,2.16,10474,48.61
8,222,465,2.16,10939,50.77
8,218,448,2.08,11387,52.85
8,214,469,2.18,11856,55.03
8,210,481,2.23,12337,57.26
8,206,455,2.11,12792,59.37
8,202,468,2.17,13260,61.54
8,198,438,2.03,13698,63.58
8,194,421,1.95,14119,65.53
8,190,440,2.04,14559,67.57
8,186,430,2,14989,69.57
8,182,422,1.96,15411,71.53
8,178,450,2.09,15861,73.61
8,174,391,1.81,16252,75.43
8,170,369,1.71,16621,77.14
8,166,405,1.88,17026,79.02
8,162,379,1.76,17405,80.78
8,158,308,1.43,17713,82.21
8,154,296,1.37,18009,83.58
8,150,302,1.4,18311,84.99
8,146,300,1.39,18611,86.38
8,142,252,1.17,18863,87.55
8,138,207,0.96,19070,88.51
8,134,172,0.8,19242,89.31
8,130,183,0.85,19425,90.16
8,126,150,0.7,19575,90.85
8,122,144,0.67,19719,91.52
8,118,114,0.53,19833,92.05
8,114,111,0.52,19944,92.56
8,110,87,0.4,20031,92.97
8,106,86,0.4,20117,93.37
8,102,71,0.33,20188,93.7
8,98,84,0.39,20272,94.09
8,94,57,0.26,20329,94.35
8,90,48,0.22,20377,94.57
8,86,56,0.26,20433,94.83
8,82,36,0.17,20469,95
8,78,51,0.24,20520,95.24
8,74,27,0.13,20547,95.36
8,70,20,0.09,20567,95.46
8,66,6,0.03,20573,95.48
8,62,15,0.07,20588,95.55
8,58,17,0.08,20605,95.63
8,54,9,0.04,20614,95.67
8,50,14,0.06,20628,95.74
8,46,6,0.03,20634,95.77
8,42,9,0.04,20643,95.81
8,38,4,0.02,20647,95.83
8,34,8,0.04,20655,95.86
8,30,7,0.03,20662,95.9
8,26,14,0.06,20676,95.96
8,22,10,0.05,20686,96.01
8,18,19,0.09,20705,96.1
8,14,16,0.07,20721,96.17
8,10,7,0.03,20728,96.2
8,6,3,0.01,20731,96.22
8,2,815,3.78,21546,100
9,298.5,0,0,0,0
9,295.5,0,0,0,0
9,292.5,0,0,0,0
9,289.5,0,0,0,0
9,286.5,0,0,0,0
9,283.5,4,0.02,4,0.02
9,280.5,11,0.05,15,0.07
9,277.5,24,0.11,39,0.17
9,274.5,22,0.1,61,0.27
9,271.5,43,0.19,104,0.47
9,268.5,59,0.26,163,0.73
9,265.5,69,0.31,232,1.04
9,262.5,100,0.45,332,1.49
9,259.5,115,0.52,447,2
9,256.5,131,0.59,578,2.59
9,253.5,177,0.79,755,3.39
9,250.5,204,0.92,959,4.3
9,247.5,205,0.92,1164,5.22
9,244.5,229,1.03,1393,6.25
9,241.5,268,1.2,1661,7.45
9,238.5,282,1.26,1943,8.71
9,235.5,268,1.2,2211,9.92
9,232.5,297,1.33,2508,11.25
9,229.5,309,1.39,2817,12.64
9,226.5,306,1.37,3123,14.01
9,223.5,321,1.44,3444,15.45
9,220.5,305,1.37,3749,16.82
9,217.5,312,1.4,4061,18.21
9,214.5,333,1.49,4394,19.71
9,211.5,325,1.46,4719,21.17
9,208.5,314,1.41,5033,22.57
9,205.5,326,1.46,5359,24.04
9,202.5,321,1.44,5680,25.48
9,199.5,361,1.62,6041,27.1
9,196.5,319,1.43,6360,28.53
9,193.5,327,1.47,6687,29.99
9,190.5,340,1.53,7027,31.52
9,187.5,307,1.38,7334,32.9
9,184.5,342,1.53,7676,34.43
9,181.5,321,1.44,7997,35.87
9,178.5,314,1.41,8311,37.28
9,175.5,333,1.49,8644,38.77
9,172.5,315,1.41,8959,40.18
9,169.5,352,1.58,9311,41.76
9,166.5,370,1.66,9681,43.42
9,163.5,334,1.5,10015,44.92
9,160.5,341,1.53,10356,46.45
9,157.5,357,1.6,10713,48.05
9,154.5,359,1.61,11072,49.66
9,151.5,375,1.68,11447,51.34
9,148.5,329,1.48,11776,52.82
9,145.5,415,1.86,12191,54.68
9,142.5,424,1.9,12615,56.58
9,139.5,375,1.68,12990,58.26
9,136.5,387,1.74,13377,60
9,133.5,387,1.74,13764,61.74
9,130.5,406,1.82,14170,63.56
9,127.5,403,1.81,14573,65.36
9,124.5,417,1.87,14990,67.23
9,121.5,421,1.89,15411,69.12
9,118.5,390,1.75,15801,70.87
9,115.5,375,1.68,16176,72.55
9,112.5,402,1.8,16578,74.36
9,109.5,388,1.74,16966,76.1
9,106.5,377,1.69,17343,77.79
9,103.5,373,1.67,17716,79.46
9,100.5,345,1.55,18061,81.01
9,97.5,353,1.58,18414,82.59
9,94.5,334,1.5,18748,84.09
9,91.5,333,1.49,19081,85.58
9,88.5,302,1.35,19383,86.94
9,85.5,294,1.32,19677,88.26
9,82.5,263,1.18,19940,89.44
9,79.5,225,1.01,20165,90.45
9,76.5,217,0.97,20382,91.42
9,73.5,180,0.81,20562,92.23
9,70.5,170,0.76,20732,92.99
9,67.5,125,0.56,20857,93.55
9,64.5,116,0.52,20973,94.07
9,61.5,95,0.43,21068,94.5
9,58.5,69,0.31,21137,94.81
9,55.5,65,0.29,21202,95.1
9,52.5,45,0.2,21247,95.3
9,49.5,37,0.17,21284,95.47
9,46.5,31,0.14,21315,95.6
9,43.5,30,0.13,21345,95.74
9,40.5,13,0.06,21358,95.8
9,37.5,18,0.08,21376,95.88
9,34.5,14,0.06,21390,95.94
9,31.5,14,0.06,21404,96
9,28.5,7,0.03,21411,96.03
9,25.5,9,0.04,21420,96.08
9,22.5,13,0.06,21433,96.13
9,19.5,13,0.06,21446,96.19
9,16.5,9,0.04,21455,96.23
9,13.5,7,0.03,21462,96.26
9,10.5,5,0.02,21467,96.29
9,7.5,6,0.03,21473,96.31
9,4.5,1,0,21474,96.32
9,1.5,821,3.68,22295,100
10,298.5,0,0,0,0
10,295.5,0,0,0,0
10,292.5,0,0,0,0
10,289.5,1,0,1,0
10,286.5,2,0.01,3,0.01
10,283.5,4,0.02,7,0.03
10,280.5,9,0.04,16,0.07
10,277.5,12,0.05,28,0.12
10,274.5,21,0.09,49,0.21
10,271.5,22,0.1,71,0.31
10,268.5,34,0.15,105,0.46
10,265.5,49,0.21,154,0.67
10,262.5,67,0.29,221,0.96
10,259.5,100,0.43,321,1.39
10,256.5,129,0.56,450,1.95
10,253.5,134,0.58,584,2.53
10,250.5,163,0.71,747,3.24
10,247.5,183,0.79,930,4.03
10,244.5,197,0.85,1127,4.89
10,241.5,217,0.94,1344,5.83
10,238.5,237,1.03,1581,6.86
10,235.5,243,1.05,1824,7.91
10,232.5,285,1.24,2109,9.15
10,229.5,305,1.32,2414,10.47
10,226.5,311,1.35,2725,11.82
10,223.5,331,1.44,3056,13.26
10,220.5,332,1.44,3388,14.7
10,217.5,366,1.59,3754,16.29
10,214.5,373,1.62,4127,17.91
10,211.5,352,1.53,4479,19.43
10,208.5,319,1.38,4798,20.82
10,205.5,363,1.57,5161,22.39
10,202.5,366,1.59,5527,23.98
10,199.5,412,1.79,5939,25.77
10,196.5,368,1.6,6307,27.36
10,193.5,409,1.77,6716,29.14
10,190.5,391,1.7,7107,30.83
10,187.5,387,1.68,7494,32.51
10,184.5,387,1.68,7881,34.19
10,181.5,412,1.79,8293,35.98
10,178.5,406,1.76,8699,37.74
10,175.5,399,1.73,9098,39.47
10,172.5,400,1.74,9498,41.21
10,169.5,393,1.71,9891,42.91
10,166.5,391,1.7,10282,44.61
10,163.5,367,1.59,10649,46.2
10,160.5,410,1.78,11059,47.98
10,157.5,377,1.64,11436,49.62
10,154.5,374,1.62,11810,51.24
10,151.5,365,1.58,12175,52.82
10,148.5,347,1.51,12522,54.33
10,145.5,348,1.51,12870,55.84
10,142.5,325,1.41,13195,57.25
10,139.5,338,1.47,13533,58.71
10,136.5,296,1.28,13829,60
10,133.5,325,1.41,14154,61.41
10,130.5,336,1.46,14490,62.87
10,127.5,316,1.37,14806,64.24
10,124.5,325,1.41,15131,65.65
10,121.5,304,1.32,15435,66.97
10,118.5,314,1.36,15749,68.33
10,115.5,313,1.36,16062,69.69
10,112.5,303,1.31,16365,71
10,109.5,297,1.29,16662,72.29
10,106.5,289,1.25,16951,73.54
10,103.5,307,1.33,17258,74.88
10,100.5,307,1.33,17565,76.21
10,97.5,295,1.28,17860,77.49
10,94.5,281,1.22,18141,78.71
10,91.5,270,1.17,18411,79.88
10,88.5,285,1.24,18696,81.11
10,85.5,281,1.22,18977,82.33
10,82.5,282,1.22,19259,83.56
10,79.5,251,1.09,19510,84.65
10,76.5,270,1.17,19780,85.82
10,73.5,222,0.96,20002,86.78
10,70.5,238,1.03,20240,87.81
10,67.5,236,1.02,20476,88.84
10,64.5,237,1.03,20713,89.87
10,61.5,232,1.01,20945,90.87
10,58.5,181,0.79,21126,91.66
10,55.5,169,0.73,21295,92.39
10,52.5,156,0.68,21451,93.07
10,49.5,146,0.63,21597,93.7
10,46.5,138,0.6,21735,94.3
10,43.5,94,0.41,21829,94.71
10,40.5,80,0.35,21909,95.05
10,37.5,44,0.19,21953,95.24
10,34.5,58,0.25,22011,95.5
10,31.5,36,0.16,22047,95.65
10,28.5,26,0.11,22073,95.77
10,25.5,11,0.05,22084,95.81
10,22.5,11,0.05,22095,95.86
10,19.5,12,0.05,22107,95.91
10,16.5,9,0.04,22116,95.95
10,13.5,4,0.02,22120,95.97
10,10.5,5,0.02,22125,95.99
10,7.5,1,0,22126,96
10,4.5,0,0,22126,96
10,1.5,923,4,23049,100
11,398,0,0,0,0
11,394,0,0,0,0
11,390,0,0,0,0
11,386,0,0,0,0
11,382,1,0.01,1,0.01
11,378,1,0.01,2,0.01
11,374,8,0.05,10,0.07
11,370,7,0.05,17,0.11
11,366,11,0.07,28,0.18
11,362,29,0.19,57,0.37
11,358,34,0.22,91,0.6
11,354,40,0.26,131,0.86
11,350,62,0.41,193,1.26
11,346,90,0.59,283,1.85
11,342,124,0.81,407,2.66
11,338,142,0.93,549,3.59
11,334,155,1.01,704,4.6
11,330,187,1.22,891,5.83
11,326,194,1.27,1085,7.1
11,322,219,1.43,1304,8.53
11,318,222,1.45,1526,9.98
11,314,230,1.5,1756,11.48
11,310,277,1.81,2033,13.29
11,306,260,1.7,2293,14.99
11,302,275,1.8,2568,16.79
11,298,225,1.47,2793,18.26
11,294,241,1.58,3034,19.84
11,290,268,1.75,3302,21.59
11,286,289,1.89,3591,23.48
11,282,238,1.56,3829,25.04
11,278,250,1.63,4079,26.67
11,274,255,1.67,4334,28.34
11,270,237,1.55,4571,29.89
11,266,219,1.43,4790,31.32
11,262,274,1.79,5064,33.12
11,258,275,1.8,5339,34.91
11,254,247,1.62,5586,36.53
11,250,215,1.41,5801,37.93
11,246,235,1.54,6036,39.47
11,242,277,1.81,6313,41.28
11,238,259,1.69,6572,42.98
11,234,267,1.75,6839,44.72
11,230,245,1.6,7084,46.32
11,226,238,1.56,7322,47.88
11,222,234,1.53,7556,49.41
11,218,257,1.68,7813,51.09
11,214,239,1.56,8052,52.65
11,210,243,1.59,8295,54.24
11,206,234,1.53,8529,55.77
11,202,242,1.58,8771,57.36
11,198,186,1.22,8957,58.57
11,194,220,1.44,9177,60.01
11,190,224,1.46,9401,61.48
11,186,214,1.4,9615,62.88
11,182,223,1.46,9838,64.33
11,178,215,1.41,10053,65.74
11,174,214,1.4,10267,67.14
11,170,181,1.18,10448,68.32
11,166,190,1.24,10638,69.57
11,162,214,1.4,10852,70.97
11,158,207,1.35,11059,72.32
11,154,197,1.29,11256,73.61
11,150,211,1.38,11467,74.99
11,146,179,1.17,11646,76.16
11,142,169,1.11,11815,77.26
11,138,176,1.15,11991,78.41
11,134,186,1.22,12177,79.63
11,130,159,1.04,12336,80.67
11,126,175,1.14,12511,81.81
11,122,163,1.07,12674,82.88
11,118,177,1.16,12851,84.04
11,114,153,1,13004,85.04
11,110,155,1.01,13159,86.05
11,106,143,0.94,13302,86.99
11,102,150,0.98,13452,87.97
11,98,141,0.92,13593,88.89
11,94,112,0.73,13705,89.62
11,90,120,0.78,13825,90.41
11,86,127,0.83,13952,91.24
11,82,103,0.67,14055,91.91
11,78,89,0.58,14144,92.49
11,74,91,0.6,14235,93.09
11,70,83,0.54,14318,93.63
11,66,70,0.46,14388,94.09
11,62,49,0.32,14437,94.41
11,58,42,0.27,14479,94.68
11,54,25,0.16,14504,94.85
11,50,21,0.14,14525,94.98
11,46,19,0.12,14544,95.11
11,42,10,0.07,14554,95.17
11,38,14,0.09,14568,95.27
11,34,12,0.08,14580,95.34
11,30,5,0.03,14585,95.38
11,26,9,0.06,14594,95.44
11,22,4,0.03,14598,95.46
11,18,7,0.05,14605,95.51
11,14,2,0.01,14607,95.52
11,10,3,0.02,14610,95.54
11,6,0,0,14610,95.54
11,2,682,4.46,15292,100
12,298.5,0,0,0,0
12,295.5,0,0,0,0
12,292.5,0,0,0,0
12,289.5,0,0,0,0
12,286.5,2,0.01,2,0.01
12,283.5,1,0,3,0.01
12,280.5,5,0.02,8,0.04
12,277.5,9,0.04,17,0.08
12,274.5,12,0.06,29,0.13
12,271.5,18,0.08,47,0.22
12,268.5,27,0.12,74,0.34
12,265.5,32,0.15,106,0.49
12,262.5,34,0.16,140,0.64
12,259.5,53,0.24,193,0.89
12,256.5,91,0.42,284,1.3
12,253.5,98,0.45,382,1.75
12,250.5,109,0.5,491,2.25
12,247.5,112,0.51,603,2.77
12,244.5,142,0.65,745,3.42
12,241.5,174,0.8,919,4.22
12,238.5,187,0.86,1106,5.07
12,235.5,192,0.88,1298,5.95
12,232.5,236,1.08,1534,7.04
12,229.5,233,1.07,1767,8.1
12,226.5,248,1.14,2015,9.24
12,223.5,285,1.31,2300,10.55
12,220.5,304,1.39,2604,11.94
12,217.5,307,1.41,2911,13.35
12,214.5,278,1.28,3189,14.63
12,211.5,301,1.38,3490,16.01
12,208.5,347,1.59,3837,17.6
12,205.5,327,1.5,4164,19.1
12,202.5,356,1.63,4520,20.73
12,199.5,341,1.56,4861,22.3
12,196.5,368,1.69,5229,23.98
12,193.5,344,1.58,5573,25.56
12,190.5,346,1.59,5919,27.15
12,187.5,374,1.72,6293,28.86
12,184.5,379,1.74,6672,30.6
12,181.5,369,1.69,7041,32.29
12,178.5,375,1.72,7416,34.01
12,175.5,411,1.89,7827,35.9
12,172.5,398,1.83,8225,37.72
12,169.5,428,1.96,8653,39.69
12,166.5,365,1.67,9018,41.36
12,163.5,412,1.89,9430,43.25
12,160.5,355,1.63,9785,44.88
12,157.5,407,1.87,10192,46.75
12,154.5,394,1.81,10586,48.55
12,151.5,377,1.73,10963,50.28
12,148.5,390,1.79,11353,52.07
12,145.5,375,1.72,11728,53.79
12,142.5,346,1.59,12074,55.38
12,139.5,351,1.61,12425,56.99
12,136.5,357,1.64,12782,58.62
12,133.5,367,1.68,13149,60.31
12,130.5,344,1.58,13493,61.89
12,127.5,309,1.42,13802,63.3
12,124.5,314,1.44,14116,64.74
12,121.5,308,1.41,14424,66.16
12,118.5,322,1.48,14746,67.63
12,115.5,286,1.31,15032,68.94
12,112.5,294,1.35,15326,70.29
12,109.5,305,1.4,15631,71.69
12,106.5,324,1.49,15955,73.18
12,103.5,306,1.4,16261,74.58
12,100.5,292,1.34,16553,75.92
12,97.5,336,1.54,16889,77.46
12,94.5,271,1.24,17160,78.7
12,91.5,280,1.28,17440,79.99
12,88.5,301,1.38,17741,81.37
12,85.5,284,1.3,18025,82.67
12,82.5,328,1.5,18353,84.18
12,79.5,274,1.26,18627,85.43
12,76.5,238,1.09,18865,86.52
12,73.5,234,1.07,19099,87.6
12,70.5,230,1.05,19329,88.65
12,67.5,217,1,19546,89.65
12,64.5,224,1.03,19770,90.68
12,61.5,215,0.99,19985,91.66
12,58.5,187,0.86,20172,92.52
12,55.5,172,0.79,20344,93.31
12,52.5,124,0.57,20468,93.88
12,49.5,124,0.57,20592,94.45
12,46.5,84,0.39,20676,94.83
12,43.5,72,0.33,20748,95.16
12,40.5,48,0.22,20796,95.38
12,37.5,35,0.16,20831,95.54
12,34.5,30,0.14,20861,95.68
12,31.5,24,0.11,20885,95.79
12,28.5,18,0.08,20903,95.87
12,25.5,25,0.11,20928,95.99
12,22.5,12,0.06,20940,96.04
12,19.5,17,0.08,20957,96.12
12,16.5,4,0.02,20961,96.14
12,13.5,1,0,20962,96.14
12,10.5,4,0.02,20966,96.16
12,7.5,0,0,20966,96.16
12,4.5,0,0,20966,96.16
12,1.5,837,3.84,21803,100
13,398,0,0,0,0
13,394,0,0,0,0
13,390,0,0,0,0
13,386,0,0,0,0
13,382,0,0,0,0
13,378,0,0,0,0
13,374,2,0.01,2,0.01
13,370,9,0.07,11,0.08
13,366,11,0.08,22,0.16
13,362,14,0.1,36,0.26
13,358,23,0.17,59,0.43
13,354,25,0.18,84,0.61
13,350,45,0.33,129,0.94
13,346,43,0.31,172,1.25
13,342,100,0.73,272,1.98
13,338,97,0.71,369,2.68
13,334,102,0.74,471,3.42
13,330,150,1.09,621,4.51
13,326,136,0.99,757,5.5
13,322,172,1.25,929,6.75
13,318,190,1.38,1119,8.14
13,314,209,1.52,1328,9.65
13,310,210,1.53,1538,11.18
13,306,223,1.62,1761,12.8
13,302,206,1.5,1967,14.3
13,298,228,1.66,2195,15.96
13,294,217,1.58,2412,17.54
13,290,223,1.62,2635,19.16
13,286,255,1.85,2890,21.01
13,282,228,1.66,3118,22.67
13,278,241,1.75,3359,24.42
13,274,215,1.56,3574,25.98
13,270,232,1.69,3806,27.67
13,266,246,1.79,4052,29.46
13,262,222,1.61,4274,31.07
13,258,237,1.72,4511,32.8
13,254,198,1.44,4709,34.23
13,250,222,1.61,4931,35.85
13,246,225,1.64,5156,37.48
13,242,234,1.7,5390,39.19
13,238,227,1.65,5617,40.84
13,234,266,1.93,5883,42.77
13,230,238,1.73,6121,44.5
13,226,234,1.7,6355,46.2
13,222,240,1.74,6595,47.95
13,218,254,1.85,6849,49.79
13,214,230,1.67,7079,51.46
13,210,242,1.76,7321,53.22
13,206,214,1.56,7535,54.78
13,202,200,1.45,7735,56.23
13,198,237,1.72,7972,57.96
13,194,211,1.53,8183,59.49
13,190,205,1.49,8388,60.98
13,186,190,1.38,8578,62.36
13,182,221,1.61,8799,63.97
13,178,190,1.38,8989,65.35
13,174,225,1.64,9214,66.99
13,170,182,1.32,9396,68.31
13,166,187,1.36,9583,69.67
13,162,193,1.4,9776,71.07
13,158,166,1.21,9942,72.28
13,154,205,1.49,10147,73.77
13,150,175,1.27,10322,75.04
13,146,151,1.1,10473,76.14
13,142,176,1.28,10649,77.42
13,138,188,1.37,10837,78.79
13,134,168,1.22,11005,80.01
13,130,168,1.22,11173,81.23
13,126,168,1.22,11341,82.45
13,122,158,1.15,11499,83.6
13,118,172,1.25,11671,84.85
13,114,129,0.94,11800,85.79
13,110,160,1.16,11960,86.95
13,106,130,0.95,12090,87.9
13,102,119,0.87,12209,88.76
13,98,119,0.87,12328,89.63
13,94,109,0.79,12437,90.42
13,90,105,0.76,12542,91.18
13,86,99,0.72,12641,91.9
13,82,90,0.65,12731,92.56
13,78,70,0.51,12801,93.06
13,74,70,0.51,12871,93.57
13,70,64,0.47,12935,94.04
13,66,43,0.31,12978,94.35
13,62,35,0.25,13013,94.61
13,58,34,0.25,13047,94.85
13,54,26,0.19,13073,95.04
13,50,18,0.13,13091,95.17
13,46,12,0.09,13103,95.26
13,42,9,0.07,13112,95.33
13,38,7,0.05,13119,95.38
13,34,10,0.07,13129,95.45
13,30,5,0.04,13134,95.49
13,26,7,0.05,13141,95.54
13,22,7,0.05,13148,95.59
13,18,7,0.05,13155,95.64
13,14,1,0.01,13156,95.65
13,10,4,0.03,13160,95.67
13,6,0,0,13160,95.67
13,2,595,4.33,13755,100
14,398,0,0,0,0
14,394,0,0,0,0
14,390,0,0,0,0
14,386,0,0,0,0
14,382,2,0.01,2,0.01
14,378,2,0.01,4,0.02
14,374,5,0.02,9,0.04
14,370,16,0.07,25,0.12
14,366,15,0.07,40,0.19
14,362,24,0.11,64,0.3
14,358,31,0.14,95,0.44
14,354,49,0.23,144,0.67
14,350,58,0.27,202,0.94
14,346,87,0.41,289,1.35
14,342,94,0.44,383,1.79
14,338,158,0.74,541,2.53
14,334,161,0.75,702,3.28
14,330,129,0.6,831,3.89
14,326,182,0.85,1013,4.74
14,322,206,0.96,1219,5.7
14,318,223,1.04,1442,6.74
14,314,224,1.05,1666,7.79
14,310,249,1.16,1915,8.95
14,306,293,1.37,2208,10.32
14,302,294,1.37,2502,11.7
14,298,282,1.32,2784,13.02
14,294,291,1.36,3075,14.38
14,290,301,1.41,3376,15.78
14,286,344,1.61,3720,17.39
14,282,325,1.52,4045,18.91
14,278,321,1.5,4366,20.41
14,274,353,1.65,4719,22.06
14,270,323,1.51,5042,23.57
14,266,352,1.65,5394,25.22
14,262,330,1.54,5724,26.76
14,258,346,1.62,6070,28.38
14,254,366,1.71,6436,30.09
14,250,374,1.75,6810,31.84
14,246,383,1.79,7193,33.63
14,242,366,1.71,7559,35.34
14,238,382,1.79,7941,37.13
14,234,377,1.76,8318,38.89
14,230,373,1.74,8691,40.63
14,226,405,1.89,9096,42.53
14,222,339,1.58,9435,44.11
14,218,397,1.86,9832,45.97
14,214,397,1.86,10229,47.82
14,210,367,1.72,10596,49.54
14,206,374,1.75,10970,51.29
14,202,348,1.63,11318,52.92
14,198,358,1.67,11676,54.59
14,194,329,1.54,12005,56.13
14,190,353,1.65,12358,57.78
14,186,323,1.51,12681,59.29
14,182,305,1.43,12986,60.71
14,178,315,1.47,13301,62.19
14,174,325,1.52,13626,63.71
14,170,298,1.39,13924,65.1
14,166,338,1.58,14262,66.68
14,162,269,1.26,14531,67.94
14,158,319,1.49,14850,69.43
14,154,275,1.29,15125,70.71
14,150,298,1.39,15423,72.11
14,146,279,1.3,15702,73.41
14,142,317,1.48,16019,74.89
14,138,290,1.36,16309,76.25
14,134,314,1.47,16623,77.72
14,130,274,1.28,16897,79
14,126,306,1.43,17203,80.43
14,122,270,1.26,17473,81.69
14,118,279,1.3,17752,83
14,114,267,1.25,18019,84.24
14,110,273,1.28,18292,85.52
14,106,252,1.18,18544,86.7
14,102,244,1.14,18788,87.84
14,98,244,1.14,19032,88.98
14,94,208,0.97,19240,89.95
14,90,191,0.89,19431,90.85
14,86,184,0.86,19615,91.71
14,82,152,0.71,19767,92.42
14,78,185,0.86,19952,93.28
14,74,135,0.63,20087,93.91
14,70,115,0.54,20202,94.45
14,66,96,0.45,20298,94.9
14,62,73,0.34,20371,95.24
14,58,57,0.27,20428,95.51
14,54,33,0.15,20461,95.66
14,50,26,0.12,20487,95.78
14,46,12,0.06,20499,95.84
14,42,14,0.07,20513,95.9
14,38,14,0.07,20527,95.97
14,34,13,0.06,20540,96.03
14,30,6,0.03,20546,96.06
14,26,9,0.04,20555,96.1
14,22,9,0.04,20564,96.14
14,18,8,0.04,20572,96.18
14,14,0,0,20572,96.18
14,10,3,0.01,20575,96.19
14,6,0,0,20575,96.19
14,2,814,3.81,21389,100
15,497.5,0,0,0,0
15,492.5,0,0,0,0
15,487.5,0,0,0,0
15,482.5,0,0,0,0
15,477.5,0,0,0,0
15,472.5,1,0.01,1,0.01
15,467.5,5,0.04,6,0.04
15,462.5,15,0.11,21,0.15
15,457.5,8,0.06,29,0.21
15,452.5,22,0.16,51,0.37
15,447.5,29,0.21,80,0.59
15,442.5,37,0.27,117,0.86
15,437.5,57,0.42,174,1.27
15,432.5,87,0.64,261,1.91
15,427.5,115,0.84,376,2.75
15,422.5,116,0.85,492,3.6
15,417.5,153,1.12,645,4.72
15,412.5,136,1,781,5.72
15,407.5,177,1.3,958,7.02
15,402.5,194,1.42,1152,8.44
15,397.5,200,1.46,1352,9.9
15,392.5,209,1.53,1561,11.43
15,387.5,230,1.68,1791,13.12
15,382.5,219,1.6,2010,14.72
15,377.5,236,1.73,2246,16.45
15,372.5,213,1.56,2459,18.01
15,367.5,244,1.79,2703,19.79
15,362.5,227,1.66,2930,21.46
15,357.5,220,1.61,3150,23.07
15,352.5,226,1.65,3376,24.72
15,347.5,218,1.6,3594,26.32
15,342.5,239,1.75,3833,28.07
15,337.5,224,1.64,4057,29.71
15,332.5,231,1.69,4288,31.4
15,327.5,233,1.71,4521,33.11
15,322.5,199,1.46,4720,34.56
15,317.5,208,1.52,4928,36.09
15,312.5,238,1.74,5166,37.83
15,307.5,221,1.62,5387,39.45
15,302.5,215,1.57,5602,41.02
15,297.5,221,1.62,5823,42.64
15,292.5,256,1.87,6079,44.52
15,287.5,230,1.68,6309,46.2
15,282.5,236,1.73,6545,47.93
15,277.5,242,1.77,6787,49.7
15,272.5,247,1.81,7034,51.51
15,267.5,210,1.54,7244,53.05
15,262.5,224,1.64,7468,54.69
15,257.5,181,1.33,7649,56.01
15,252.5,220,1.61,7869,57.62
15,247.5,221,1.62,8090,59.24
15,242.5,205,1.5,8295,60.74
15,237.5,201,1.47,8496,62.21
15,232.5,200,1.46,8696,63.68
15,227.5,187,1.37,8883,65.05
15,222.5,201,1.47,9084,66.52
15,217.5,176,1.29,9260,67.81
15,212.5,185,1.35,9445,69.16
15,207.5,186,1.36,9631,70.53
15,202.5,164,1.2,9795,71.73
15,197.5,167,1.22,9962,72.95
15,192.5,181,1.33,10143,74.28
15,187.5,187,1.37,10330,75.64
15,182.5,185,1.35,10515,77
15,177.5,163,1.19,10678,78.19
15,172.5,153,1.12,10831,79.31
15,167.5,152,1.11,10983,80.43
15,162.5,180,1.32,11163,81.74
15,157.5,138,1.01,11301,82.75
15,152.5,158,1.16,11459,83.91
15,147.5,167,1.22,11626,85.13
15,142.5,145,1.06,11771,86.2
15,137.5,122,0.89,11893,87.09
15,132.5,125,0.92,12018,88.01
15,127.5,145,1.06,12163,89.07
15,122.5,113,0.83,12276,89.89
15,117.5,112,0.82,12388,90.71
15,112.5,72,0.53,12460,91.24
15,107.5,89,0.65,12549,91.89
15,102.5,86,0.63,12635,92.52
15,97.5,81,0.59,12716,93.12
15,92.5,76,0.56,12792,93.67
15,87.5,64,0.47,12856,94.14
15,82.5,42,0.31,12898,94.45
15,77.5,29,0.21,12927,94.66
15,72.5,39,0.29,12966,94.95
15,67.5,14,0.1,12980,95.05
15,62.5,24,0.18,13004,95.23
15,57.5,11,0.08,13015,95.31
15,52.5,6,0.04,13021,95.35
15,47.5,7,0.05,13028,95.4
15,42.5,2,0.01,13030,95.42
15,37.5,8,0.06,13038,95.47
15,32.5,7,0.05,13045,95.53
15,27.5,7,0.05,13052,95.58
15,22.5,6,0.04,13058,95.62
15,17.5,7,0.05,13065,95.67
15,12.5,2,0.01,13067,95.69
15,7.5,1,0.01,13068,95.69
15,2.5,588,4.31,13656,100
16,298.5,0,0,0,0
16,295.5,0,0,0,0
16,292.5,0,0,0,0
16,289.5,0,0,0,0
16,286.5,0,0,0,0
16,283.5,4,0.03,4,0.03
16,280.5,10,0.07,14,0.1
16,277.5,10,0.07,24,0.16
16,274.5,27,0.18,51,0.35
16,271.5,57,0.39,108,0.73
16,268.5,88,0.6,196,1.33
16,265.5,107,0.73,303,2.06
16,262.5,147,1,450,3.06
16,259.5,183,1.25,633,4.31
16,256.5,218,1.48,851,5.79
16,253.5,209,1.42,1060,7.21
16,250.5,232,1.58,1292,8.79
16,247.5,265,1.8,1557,10.59
16,244.5,285,1.94,1842,12.53
16,241.5,302,2.05,2144,14.59
16,238.5,305,2.08,2449,16.66
16,235.5,317,2.16,2766,18.82
16,232.5,289,1.97,3055,20.79
16,229.5,284,1.93,3339,22.72
16,226.5,303,2.06,3642,24.78
16,223.5,292,1.99,3934,26.77
16,220.5,263,1.79,4197,28.56
16,217.5,310,2.11,4507,30.67
16,214.5,306,2.08,4813,32.75
16,211.5,290,1.97,5103,34.72
16,208.5,280,1.91,5383,36.63
16,205.5,295,2.01,5678,38.63
16,202.5,261,1.78,5939,40.41
16,199.5,303,2.06,6242,42.47
16,196.5,298,2.03,6540,44.5
16,193.5,260,1.77,6800,46.27
16,190.5,259,1.76,7059,48.03
16,187.5,262,1.78,7321,49.81
16,184.5,283,1.93,7604,51.74
16,181.5,289,1.97,7893,53.7
16,178.5,239,1.63,8132,55.33
16,175.5,300,2.04,8432,57.37
16,172.5,281,1.91,8713,59.28
16,169.5,268,1.82,8981,61.11
16,166.5,262,1.78,9243,62.89
16,163.5,280,1.91,9523,64.8
16,160.5,247,1.68,9770,66.48
16,157.5,224,1.52,9994,68
16,154.5,273,1.86,10267,69.86
16,151.5,238,1.62,10505,71.48
16,148.5,213,1.45,10718,72.93
16,145.5,217,1.48,10935,74.4
16,142.5,229,1.56,11164,75.96
16,139.5,212,1.44,11376,77.4
16,136.5,198,1.35,11574,78.75
16,133.5,189,1.29,11763,80.04
16,130.5,177,1.2,11940,81.24
16,127.5,158,1.08,12098,82.32
16,124.5,183,1.25,12281,83.56
16,121.5,153,1.04,12434,84.6
16,118.5,156,1.06,12590,85.66
16,115.5,167,1.14,12757,86.8
16,112.5,132,0.9,12889,87.7
16,109.5,114,0.78,13003,88.47
16,106.5,102,0.69,13105,89.17
16,103.5,94,0.64,13199,89.81
16,100.5,123,0.84,13322,90.64
16,97.5,94,0.64,13416,91.28
16,94.5,78,0.53,13494,91.81
16,91.5,64,0.44,13558,92.25
16,88.5,66,0.45,13624,92.7
16,85.5,63,0.43,13687,93.13
16,82.5,61,0.42,13748,93.54
16,79.5,48,0.33,13796,93.87
16,76.5,44,0.3,13840,94.17
16,73.5,34,0.23,13874,94.4
16,70.5,35,0.24,13909,94.64
16,67.5,27,0.18,13936,94.82
16,64.5,20,0.14,13956,94.96
16,61.5,16,0.11,13972,95.07
16,58.5,24,0.16,13996,95.23
16,55.5,14,0.1,14010,95.33
16,52.5,15,0.1,14025,95.43
16,49.5,6,0.04,14031,95.47
16,46.5,7,0.05,14038,95.52
16,43.5,4,0.03,14042,95.54
16,40.5,5,0.03,14047,95.58
16,37.5,4,0.03,14051,95.6
16,34.5,8,0.05,14059,95.66
16,31.5,1,0.01,14060,95.67
16,28.5,4,0.03,14064,95.69
16,25.5,4,0.03,14068,95.72
16,22.5,3,0.02,14071,95.74
16,19.5,0,0,14071,95.74
16,16.5,3,0.02,14074,95.76
16,13.5,0,0,14074,95.76
16,10.5,2,0.01,14076,95.77
16,7.5,0,0,14076,95.77
16,4.5,0,0,14076,95.77
16,1.5,621,4.23,14697,100
17,298.5,0,0,0,0
17,295.5,0,0,0,0
17,292.5,0,0,0,0
17,289.5,0,0,0,0
17,286.5,0,0,0,0
17,283.5,0,0,0,0
17,280.5,1,0.01,1,0.01
17,277.5,3,0.02,4,0.03
17,274.5,14,0.11,18,0.14
17,271.5,23,0.18,41,0.31
17,268.5,33,0.25,74,0.57
17,265.5,47,0.36,121,0.92
17,262.5,68,0.52,189,1.44
17,259.5,100,0.76,289,2.21
17,256.5,112,0.86,401,3.06
17,253.5,154,1.18,555,4.24
17,250.5,165,1.26,720,5.5
17,247.5,197,1.5,917,7
17,244.5,192,1.47,1109,8.47
17,241.5,218,1.67,1327,10.14
17,238.5,233,1.78,1560,11.92
17,235.5,253,1.93,1813,13.85
17,232.5,265,2.02,2078,15.87
17,229.5,254,1.94,2332,17.81
17,226.5,240,1.83,2572,19.65
17,223.5,234,1.79,2806,21.43
17,220.5,238,1.82,3044,23.25
17,217.5,287,2.19,3331,25.44
17,214.5,270,2.06,3601,27.51
17,211.5,275,2.1,3876,29.61
17,208.5,263,2.01,4139,31.61
17,205.5,263,2.01,4402,33.62
17,202.5,237,1.81,4639,35.43
17,199.5,266,2.03,4905,37.47
17,196.5,257,1.96,5162,39.43
17,193.5,263,2.01,5425,41.44
17,190.5,292,2.23,5717,43.67
17,187.5,277,2.12,5994,45.78
17,184.5,278,2.12,6272,47.91
17,181.5,282,2.15,6554,50.06
17,178.5,261,1.99,6815,52.05
17,175.5,271,2.07,7086,54.12
17,172.5,290,2.22,7376,56.34
17,169.5,282,2.15,7658,58.49
17,166.5,263,2.01,7921,60.5
17,163.5,260,1.99,8181,62.49
17,160.5,259,1.98,8440,64.47
17,157.5,245,1.87,8685,66.34
17,154.5,258,1.97,8943,68.31
17,151.5,227,1.73,9170,70.04
17,148.5,227,1.73,9397,71.78
17,145.5,242,1.85,9639,73.63
17,142.5,247,1.89,9886,75.51
17,139.5,205,1.57,10091,77.08
17,136.5,196,1.5,10287,78.57
17,133.5,203,1.55,10490,80.13
17,130.5,217,1.66,10707,81.78
17,127.5,164,1.25,10871,83.04
17,124.5,185,1.41,11056,84.45
17,121.5,151,1.15,11207,85.6
17,118.5,133,1.02,11340,86.62
17,115.5,104,0.79,11444,87.41
17,112.5,121,0.92,11565,88.34
17,109.5,114,0.87,11679,89.21
17,106.5,111,0.85,11790,90.05
17,103.5,91,0.7,11881,90.75
17,100.5,73,0.56,11954,91.31
17,97.5,67,0.51,12021,91.82
17,94.5,61,0.47,12082,92.29
17,91.5,63,0.48,12145,92.77
17,88.5,49,0.37,12194,93.14
17,85.5,47,0.36,12241,93.5
17,82.5,37,0.28,12278,93.78
17,79.5,48,0.37,12326,94.15
17,76.5,35,0.27,12361,94.42
17,73.5,29,0.22,12390,94.64
17,70.5,33,0.25,12423,94.89
17,67.5,26,0.2,12449,95.09
17,64.5,17,0.13,12466,95.22
17,61.5,17,0.13,12483,95.35
17,58.5,10,0.08,12493,95.42
17,55.5,14,0.11,12507,95.53
17,52.5,10,0.08,12517,95.61
17,49.5,4,0.03,12521,95.64
17,46.5,7,0.05,12528,95.69
17,43.5,3,0.02,12531,95.71
17,40.5,3,0.02,12534,95.74
17,37.5,8,0.06,12542,95.8
17,34.5,6,0.05,12548,95.84
17,31.5,2,0.02,12550,95.86
17,28.5,2,0.02,12552,95.88
17,25.5,2,0.02,12554,95.89
17,22.5,1,0.01,12555,95.9
17,19.5,1,0.01,12556,95.91
17,16.5,1,0.01,12557,95.91
17,13.5,3,0.02,12560,95.94
17,10.5,1,0.01,12561,95.94
17,7.5,0,0,12561,95.94
17,4.5,0,0,12561,95.94
17,1.5,531,4.06,13092,100
18,298.5,0,0,0,0
18,295.5,0,0,0,0
18,292.5,0,0,0,0
18,289.5,0,0,0,0
18,286.5,0,0,0,0
18,283.5,2,0.01,2,0.01
18,280.5,13,0.06,15,0.07
18,277.5,16,0.08,31,0.15
18,274.5,26,0.13,57,0.28
18,271.5,44,0.21,101,0.49
18,268.5,60,0.29,161,0.78
18,265.5,81,0.39,242,1.17
18,262.5,92,0.44,334,1.61
18,259.5,137,0.66,471,2.27
18,256.5,156,0.75,627,3.03
18,253.5,216,1.04,843,4.07
18,250.5,203,0.98,1046,5.05
18,247.5,235,1.13,1281,6.18
18,244.5,273,1.32,1554,7.5
18,241.5,271,1.31,1825,8.81
18,238.5,320,1.54,2145,10.35
18,235.5,327,1.58,2472,11.93
18,232.5,326,1.57,2798,13.5
18,229.5,338,1.63,3136,15.13
18,226.5,371,1.79,3507,16.92
18,223.5,379,1.83,3886,18.75
18,220.5,404,1.95,4290,20.7
18,217.5,394,1.9,4684,22.6
18,214.5,392,1.89,5076,24.49
18,211.5,398,1.92,5474,26.41
18,208.5,455,2.2,5929,28.61
18,205.5,410,1.98,6339,30.59
18,202.5,409,1.97,6748,32.56
18,199.5,395,1.91,7143,34.47
18,196.5,432,2.08,7575,36.55
18,193.5,422,2.04,7997,38.59
18,190.5,450,2.17,8447,40.76
18,187.5,400,1.93,8847,42.69
18,184.5,398,1.92,9245,44.61
18,181.5,394,1.9,9639,46.51
18,178.5,418,2.02,10057,48.53
18,175.5,392,1.89,10449,50.42
18,172.5,450,2.17,10899,52.59
18,169.5,401,1.93,11300,54.53
18,166.5,395,1.91,11695,56.43
18,163.5,413,1.99,12108,58.43
18,160.5,428,2.07,12536,60.49
18,157.5,413,1.99,12949,62.48
18,154.5,411,1.98,13360,64.47
18,151.5,366,1.77,13726,66.23
18,148.5,403,1.94,14129,68.18
18,145.5,370,1.79,14499,69.96
18,142.5,347,1.67,14846,71.64
18,139.5,367,1.77,15213,73.41
18,136.5,362,1.75,15575,75.15
18,133.5,386,1.86,15961,77.02
18,130.5,326,1.57,16287,78.59
18,127.5,348,1.68,16635,80.27
18,124.5,309,1.49,16944,81.76
18,121.5,284,1.37,17228,83.13
18,118.5,298,1.44,17526,84.57
18,115.5,317,1.53,17843,86.1
18,112.5,234,1.13,18077,87.23
18,109.5,235,1.13,18312,88.36
18,106.5,203,0.98,18515,89.34
18,103.5,198,0.96,18713,90.3
18,100.5,163,0.79,18876,91.08
18,97.5,146,0.7,19022,91.79
18,94.5,146,0.7,19168,92.49
18,91.5,112,0.54,19280,93.03
18,88.5,122,0.59,19402,93.62
18,85.5,91,0.44,19493,94.06
18,82.5,77,0.37,19570,94.43
18,79.5,65,0.31,19635,94.75
18,76.5,63,0.3,19698,95.05
18,73.5,56,0.27,19754,95.32
18,70.5,42,0.2,19796,95.52
18,67.5,25,0.12,19821,95.64
18,64.5,25,0.12,19846,95.76
18,61.5,26,0.13,19872,95.89
18,58.5,20,0.1,19892,95.99
18,55.5,15,0.07,19907,96.06
18,52.5,13,0.06,19920,96.12
18,49.5,5,0.02,19925,96.14
18,46.5,6,0.03,19931,96.17
18,43.5,4,0.02,19935,96.19
18,40.5,8,0.04,19943,96.23
18,37.5,5,0.02,19948,96.26
18,34.5,6,0.03,19954,96.28
18,31.5,4,0.02,19958,96.3
18,28.5,2,0.01,19960,96.31
18,25.5,4,0.02,19964,96.33
18,22.5,4,0.02,19968,96.35
18,19.5,3,0.01,19971,96.37
18,16.5,2,0.01,19973,96.38
18,13.5,2,0.01,19975,96.39
18,10.5,0,0,19975,96.39
18,7.5,0,0,19975,96.39
18,4.5,0,0,19975,96.39
18,1.5,749,3.61,20724,100
19,298.5,0,0,0,0
19,295.5,0,0,0,0
19,292.5,0,0,0,0
19,289.5,0,0,0,0
19,286.5,0,0,0,0
19,283.5,3,0.01,3,0.01
19,280.5,4,0.02,7,0.03
19,277.5,11,0.05,18,0.08
19,274.5,19,0.09,37,0.17
19,271.5,33,0.15,70,0.32
19,268.5,40,0.18,110,0.51
19,265.5,63,0.29,173,0.8
19,262.5,100,0.46,273,1.26
19,259.5,125,0.58,398,1.84
19,256.5,173,0.8,571,2.64
19,253.5,213,0.98,784,3.62
19,250.5,259,1.2,1043,4.82
19,247.5,299,1.38,1342,6.2
19,244.5,387,1.79,1729,7.99
19,241.5,390,1.8,2119,9.79
19,238.5,477,2.2,2596,12
19,235.5,433,2,3029,14
19,232.5,479,2.21,3508,16.21
19,229.5,475,2.2,3983,18.41
19,226.5,569,2.63,4552,21.04
19,223.5,477,2.2,5029,23.24
19,220.5,554,2.56,5583,25.8
19,217.5,485,2.24,6068,28.04
19,214.5,549,2.54,6617,30.58
19,211.5,501,2.32,7118,32.89
19,208.5,600,2.77,7718,35.67
19,205.5,558,2.58,8276,38.25
19,202.5,576,2.66,8852,40.91
19,199.5,496,2.29,9348,43.2
19,196.5,597,2.76,9945,45.96
19,193.5,503,2.32,10448,48.28
19,190.5,554,2.56,11002,50.84
19,187.5,499,2.31,11501,53.15
19,184.5,547,2.53,12048,55.68
19,181.5,462,2.14,12510,57.81
19,178.5,501,2.32,13011,60.13
19,175.5,482,2.23,13493,62.36
19,172.5,496,2.29,13989,64.65
19,169.5,453,2.09,14442,66.74
19,166.5,490,2.26,14932,69.01
19,163.5,415,1.92,15347,70.92
19,160.5,417,1.93,15764,72.85
19,157.5,367,1.7,16131,74.55
19,154.5,388,1.79,16519,76.34
19,151.5,338,1.56,16857,77.9
19,148.5,364,1.68,17221,79.58
19,145.5,309,1.43,17530,81.01
19,142.5,290,1.34,17820,82.35
19,139.5,259,1.2,18079,83.55
19,136.5,300,1.39,18379,84.93
19,133.5,210,0.97,18589,85.91
19,130.5,211,0.98,18800,86.88
19,127.5,177,0.82,18977,87.7
19,124.5,199,0.92,19176,88.62
19,121.5,169,0.78,19345,89.4
19,118.5,149,0.69,19494,90.09
19,115.5,131,0.61,19625,90.69
19,112.5,109,0.5,19734,91.2
19,109.5,102,0.47,19836,91.67
19,106.5,83,0.38,19919,92.05
19,103.5,85,0.39,20004,92.44
19,100.5,87,0.4,20091,92.85
19,97.5,59,0.27,20150,93.12
19,94.5,78,0.36,20228,93.48
19,91.5,59,0.27,20287,93.75
19,88.5,56,0.26,20343,94.01
19,85.5,68,0.31,20411,94.33
19,82.5,58,0.27,20469,94.59
19,79.5,44,0.2,20513,94.8
19,76.5,61,0.28,20574,95.08
19,73.5,31,0.14,20605,95.22
19,70.5,33,0.15,20638,95.37
19,67.5,21,0.1,20659,95.47
19,64.5,20,0.09,20679,95.56
19,61.5,18,0.08,20697,95.65
19,58.5,10,0.05,20707,95.69
19,55.5,19,0.09,20726,95.78
19,52.5,12,0.06,20738,95.84
19,49.5,10,0.05,20748,95.88
19,46.5,13,0.06,20761,95.94
19,43.5,9,0.04,20770,95.98
19,40.5,6,0.03,20776,96.01
19,37.5,4,0.02,20780,96.03
19,34.5,7,0.03,20787,96.06
19,31.5,7,0.03,20794,96.1
19,28.5,4,0.02,20798,96.11
19,25.5,4,0.02,20802,96.13
19,22.5,3,0.01,20805,96.15
19,19.5,0,0,20805,96.15
19,16.5,0,0,20805,96.15
19,13.5,0,0,20805,96.15
19,10.5,1,0,20806,96.15
19,7.5,0,0,20806,96.15
19,4.5,0,0,20806,96.15
19,1.5,833,3.85,21639,100
21,298.5,0,0,0,0
21,295.5,0,0,0,0
21,292.5,0,0,0,0
21,289.5,0,0,0,0
21,286.5,0,0,0,0
21,283.5,1,0,1,0
21,280.5,3,0.01,4,0.02
21,277.5,5,0.02,9,0.04
21,274.5,7,0.03,16,0.07
21,271.5,17,0.08,33,0.15
21,268.5,36,0.16,69,0.31
21,265.5,36,0.16,105,0.47
21,262.5,64,0.28,169,0.75
21,259.5,103,0.46,272,1.21
21,256.5,151,0.67,423,1.88
21,253.5,165,0.73,588,2.61
21,250.5,216,0.96,804,3.57
21,247.5,286,1.27,1090,4.84
21,244.5,340,1.51,1430,6.35
21,241.5,403,1.79,1833,8.14
21,238.5,446,1.98,2279,10.12
21,235.5,453,2.01,2732,12.13
21,232.5,553,2.45,3285,14.58
21,229.5,547,2.43,3832,17.01
21,226.5,618,2.74,4450,19.75
21,223.5,554,2.46,5004,22.21
21,220.5,651,2.89,5655,25.1
21,217.5,639,2.84,6294,27.94
21,214.5,591,2.62,6885,30.56
21,211.5,642,2.85,7527,33.41
21,208.5,568,2.52,8095,35.93
21,205.5,644,2.86,8739,38.79
21,202.5,635,2.82,9374,41.61
21,199.5,671,2.98,10045,44.59
21,196.5,583,2.59,10628,47.17
21,193.5,600,2.66,11228,49.84
21,190.5,648,2.88,11876,52.71
21,187.5,608,2.7,12484,55.41
21,184.5,538,2.39,13022,57.8
21,181.5,573,2.54,13595,60.34
21,178.5,551,2.45,14146,62.79
21,175.5,470,2.09,14616,64.88
21,172.5,508,2.25,15124,67.13
21,169.5,493,2.19,15617,69.32
21,166.5,451,2,16068,71.32
21,163.5,440,1.95,16508,73.27
21,160.5,442,1.96,16950,75.24
21,157.5,397,1.76,17347,77
21,154.5,383,1.7,17730,78.7
21,151.5,321,1.42,18051,80.12
21,148.5,338,1.5,18389,81.62
21,145.5,292,1.3,18681,82.92
21,142.5,238,1.06,18919,83.98
21,139.5,247,1.1,19166,85.07
21,136.5,249,1.11,19415,86.18
21,133.5,193,0.86,19608,87.03
21,130.5,211,0.94,19819,87.97
21,127.5,174,0.77,19993,88.74
21,124.5,183,0.81,20176,89.56
21,121.5,159,0.71,20335,90.26
21,118.5,119,0.53,20454,90.79
21,115.5,120,0.53,20574,91.32
21,112.5,108,0.48,20682,91.8
21,109.5,99,0.44,20781,92.24
21,106.5,76,0.34,20857,92.58
21,103.5,88,0.39,20945,92.97
21,100.5,72,0.32,21017,93.29
21,97.5,54,0.24,21071,93.53
21,94.5,65,0.29,21136,93.82
21,91.5,51,0.23,21187,94.04
21,88.5,55,0.24,21242,94.29
21,85.5,44,0.2,21286,94.48
21,82.5,53,0.24,21339,94.72
21,79.5,45,0.2,21384,94.92
21,76.5,55,0.24,21439,95.16
21,73.5,26,0.12,21465,95.28
21,70.5,33,0.15,21498,95.42
21,67.5,19,0.08,21517,95.51
21,64.5,19,0.08,21536,95.59
21,61.5,11,0.05,21547,95.64
21,58.5,13,0.06,21560,95.7
21,55.5,21,0.09,21581,95.79
21,52.5,11,0.05,21592,95.84
21,49.5,11,0.05,21603,95.89
21,46.5,7,0.03,21610,95.92
21,43.5,10,0.04,21620,95.97
21,40.5,8,0.04,21628,96
21,37.5,5,0.02,21633,96.02
21,34.5,7,0.03,21640,96.05
21,31.5,6,0.03,21646,96.08
21,28.5,2,0.01,21648,96.09
21,25.5,3,0.01,21651,96.1
21,22.5,3,0.01,21654,96.12
21,19.5,0,0,21654,96.12
21,16.5,0,0,21654,96.12
21,13.5,0,0,21654,96.12
21,10.5,1,0,21655,96.12
21,7.5,1,0,21656,96.12
21,4.5,0,0,21656,96.12
21,1.5,873,3.88,22529,100
22,298.5,0,0,0,0
22,295.5,0,0,0,0
22,292.5,0,0,0,0
22,289.5,0,0,0,0
22,286.5,0,0,0,0
22,283.5,1,0,1,0
22,280.5,1,0,2,0.01
22,277.5,1,0,3,0.01
22,274.5,6,0.02,9,0.04
22,271.5,17,0.07,26,0.11
22,268.5,18,0.07,44,0.18
22,265.5,30,0.12,74,0.3
22,262.5,56,0.23,130,0.53
22,259.5,56,0.23,186,0.76
22,256.5,124,0.51,310,1.27
22,253.5,141,0.58,451,1.84
22,250.5,185,0.76,636,2.6
22,247.5,233,0.95,869,3.55
22,244.5,288,1.18,1157,4.72
22,241.5,290,1.18,1447,5.91
22,238.5,348,1.42,1795,7.33
22,235.5,405,1.65,2200,8.98
22,232.5,467,1.91,2667,10.89
22,229.5,480,1.96,3147,12.85
22,226.5,507,2.07,3654,14.92
22,223.5,564,2.3,4218,17.22
22,220.5,522,2.13,4740,19.35
22,217.5,591,2.41,5331,21.76
22,214.5,596,2.43,5927,24.2
22,211.5,606,2.47,6533,26.67
22,208.5,643,2.63,7176,29.3
22,205.5,634,2.59,7810,31.89
22,202.5,604,2.47,8414,34.35
22,199.5,618,2.52,9032,36.87
22,196.5,611,2.49,9643,39.37
22,193.5,644,2.63,10287,42
22,190.5,632,2.58,10919,44.58
22,187.5,596,2.43,11515,47.01
22,184.5,614,2.51,12129,49.52
22,181.5,662,2.7,12791,52.22
22,178.5,582,2.38,13373,54.6
22,175.5,610,2.49,13983,57.09
22,172.5,609,2.49,14592,59.57
22,169.5,569,2.32,15161,61.9
22,166.5,546,2.23,15707,64.13
22,163.5,511,2.09,16218,66.21
22,160.5,496,2.02,16714,68.24
22,157.5,498,2.03,17212,70.27
22,154.5,462,1.89,17674,72.16
22,151.5,481,1.96,18155,74.12
22,148.5,434,1.77,18589,75.89
22,145.5,432,1.76,19021,77.66
22,142.5,369,1.51,19390,79.16
22,139.5,351,1.43,19741,80.6
22,136.5,368,1.5,20109,82.1
22,133.5,326,1.33,20435,83.43
22,130.5,280,1.14,20715,84.57
22,127.5,242,0.99,20957,85.56
22,124.5,235,0.96,21192,86.52
22,121.5,224,0.91,21416,87.43
22,118.5,204,0.83,21620,88.27
22,115.5,186,0.76,21806,89.03
22,112.5,175,0.71,21981,89.74
22,109.5,166,0.68,22147,90.42
22,106.5,153,0.62,22300,91.04
22,103.5,123,0.5,22423,91.54
22,100.5,94,0.38,22517,91.93
22,97.5,97,0.4,22614,92.32
22,94.5,116,0.47,22730,92.8
22,91.5,97,0.4,22827,93.19
22,88.5,83,0.34,22910,93.53
22,85.5,84,0.34,22994,93.88
22,82.5,81,0.33,23075,94.21
22,79.5,78,0.32,23153,94.53
22,76.5,66,0.27,23219,94.79
22,73.5,52,0.21,23271,95.01
22,70.5,53,0.22,23324,95.22
22,67.5,30,0.12,23354,95.35
22,64.5,26,0.11,23380,95.45
22,61.5,29,0.12,23409,95.57
22,58.5,17,0.07,23426,95.64
22,55.5,19,0.08,23445,95.72
22,52.5,8,0.03,23453,95.75
22,49.5,12,0.05,23465,95.8
22,46.5,10,0.04,23475,95.84
22,43.5,10,0.04,23485,95.88
22,40.5,8,0.03,23493,95.91
22,37.5,8,0.03,23501,95.95
22,34.5,8,0.03,23509,95.98
22,31.5,4,0.02,23513,95.99
22,28.5,6,0.02,23519,96.02
22,25.5,4,0.02,23523,96.04
22,22.5,4,0.02,23527,96.05
22,19.5,2,0.01,23529,96.06
22,16.5,0,0,23529,96.06
22,13.5,0,0,23529,96.06
22,10.5,1,0,23530,96.06
22,7.5,1,0,23531,96.07
22,4.5,0,0,23531,96.07
22,1.5,963,3.93,24494,100
23,398,0,0,0,0
23,394,0,0,0,0
23,390,0,0,0,0
23,386,0,0,0,0
23,382,0,0,0,0
23,378,1,0,1,0
23,374,2,0.01,3,0.01
23,370,0,0,3,0.01
23,366,9,0.04,12,0.06
23,362,15,0.07,27,0.13
23,358,21,0.1,48,0.22
23,354,33,0.15,81,0.38
23,350,43,0.2,124,0.58
23,346,84,0.39,208,0.96
23,342,86,0.4,294,1.36
23,338,143,0.66,437,2.03
23,334,187,0.87,624,2.89
23,330,221,1.03,845,3.92
23,326,262,1.22,1107,5.13
23,322,306,1.42,1413,6.55
23,318,342,1.59,1755,8.14
23,314,410,1.9,2165,10.04
23,310,442,2.05,2607,12.09
23,306,507,2.35,3114,14.44
23,302,443,2.05,3557,16.5
23,298,503,2.33,4060,18.83
23,294,513,2.38,4573,21.21
23,290,571,2.65,5144,23.86
23,286,541,2.51,5685,26.37
23,282,544,2.52,6229,28.89
23,278,514,2.38,6743,31.28
23,274,557,2.58,7300,33.86
23,270,570,2.64,7870,36.51
23,266,583,2.7,8453,39.21
23,262,587,2.72,9040,41.93
23,258,553,2.57,9593,44.5
23,254,568,2.63,10161,47.13
23,250,564,2.62,10725,49.75
23,246,560,2.6,11285,52.35
23,242,551,2.56,11836,54.9
23,238,507,2.35,12343,57.25
23,234,497,2.31,12840,59.56
23,230,531,2.46,13371,62.02
23,226,497,2.31,13868,64.33
23,222,499,2.31,14367,66.64
23,218,451,2.09,14818,68.74
23,214,435,2.02,15253,70.75
23,210,415,1.93,15668,72.68
23,206,448,2.08,16116,74.76
23,202,372,1.73,16488,76.48
23,198,357,1.66,16845,78.14
23,194,349,1.62,17194,79.76
23,190,321,1.49,17515,81.25
23,186,286,1.33,17801,82.57
23,182,270,1.25,18071,83.83
23,178,239,1.11,18310,84.93
23,174,248,1.15,18558,86.08
23,170,214,0.99,18772,87.08
23,166,184,0.85,18956,87.93
23,162,183,0.85,19139,88.78
23,158,175,0.81,19314,89.59
23,154,166,0.77,19480,90.36
23,150,142,0.66,19622,91.02
23,146,103,0.48,19725,91.5
23,142,92,0.43,19817,91.92
23,138,92,0.43,19909,92.35
23,134,81,0.38,19990,92.73
23,130,77,0.36,20067,93.08
23,126,78,0.36,20145,93.45
23,122,53,0.25,20198,93.69
23,118,62,0.29,20260,93.98
23,114,58,0.27,20318,94.25
23,110,30,0.14,20348,94.39
23,106,29,0.13,20377,94.52
23,102,28,0.13,20405,94.65
23,98,18,0.08,20423,94.74
23,94,19,0.09,20442,94.82
23,90,24,0.11,20466,94.93
23,86,39,0.18,20505,95.12
23,82,38,0.18,20543,95.29
23,78,37,0.17,20580,95.46
23,74,28,0.13,20608,95.59
23,70,28,0.13,20636,95.72
23,66,12,0.06,20648,95.78
23,62,14,0.06,20662,95.84
23,58,10,0.05,20672,95.89
23,54,17,0.08,20689,95.97
23,50,9,0.04,20698,96.01
23,46,8,0.04,20706,96.05
23,42,10,0.05,20716,96.09
23,38,5,0.02,20721,96.12
23,34,7,0.03,20728,96.15
23,30,3,0.01,20731,96.16
23,26,5,0.02,20736,96.19
23,22,4,0.02,20740,96.21
23,18,0,0,20740,96.21
23,14,0,0,20740,96.21
23,10,1,0,20741,96.21
23,6,1,0,20742,96.21
23,2,816,3.79,21558,100
24,298.5,0,0,0,0
24,295.5,0,0,0,0
24,292.5,1,0,1,0
24,289.5,0,0,1,0
24,286.5,3,0.01,4,0.02
24,283.5,9,0.04,13,0.06
24,280.5,19,0.09,32,0.14
24,277.5,28,0.13,60,0.27
24,274.5,49,0.22,109,0.49
24,271.5,59,0.26,168,0.75
24,268.5,79,0.35,247,1.11
24,265.5,125,0.56,372,1.67
24,262.5,158,0.71,530,2.38
24,259.5,160,0.72,690,3.09
24,256.5,236,1.06,926,4.15
24,253.5,239,1.07,1165,5.22
24,250.5,304,1.36,1469,6.59
24,247.5,311,1.39,1780,7.98
24,244.5,357,1.6,2137,9.58
24,241.5,361,1.62,2498,11.2
24,238.5,374,1.68,2872,12.88
24,235.5,373,1.67,3245,14.55
24,232.5,385,1.73,3630,16.28
24,229.5,431,1.93,4061,18.21
24,226.5,424,1.9,4485,20.11
24,223.5,418,1.87,4903,21.99
24,220.5,438,1.96,5341,23.95
24,217.5,445,2,5786,25.95
24,214.5,421,1.89,6207,27.83
24,211.5,379,1.7,6586,29.53
24,208.5,405,1.82,6991,31.35
24,205.5,417,1.87,7408,33.22
24,202.5,463,2.08,7871,35.3
24,199.5,396,1.78,8267,37.07
24,196.5,448,2.01,8715,39.08
24,193.5,405,1.82,9120,40.9
24,190.5,436,1.96,9556,42.85
24,187.5,455,2.04,10011,44.89
24,184.5,455,2.04,10466,46.93
24,181.5,444,1.99,10910,48.92
24,178.5,445,2,11355,50.92
24,175.5,437,1.96,11792,52.88
24,172.5,456,2.04,12248,54.92
24,169.5,447,2,12695,56.93
24,166.5,514,2.3,13209,59.23
24,163.5,448,2.01,13657,61.24
24,160.5,461,2.07,14118,63.31
24,157.5,433,1.94,14551,65.25
24,154.5,478,2.14,15029,67.39
24,151.5,452,2.03,15481,69.42
24,148.5,435,1.95,15916,71.37
24,145.5,398,1.78,16314,73.16
24,142.5,417,1.87,16731,75.03
24,139.5,350,1.57,17081,76.6
24,136.5,380,1.7,17461,78.3
24,133.5,304,1.36,17765,79.66
24,130.5,373,1.67,18138,81.34
24,127.5,305,1.37,18443,82.7
24,124.5,315,1.41,18758,84.12
24,121.5,251,1.13,19009,85.24
24,118.5,265,1.19,19274,86.43
24,115.5,224,1,19498,87.43
24,112.5,229,1.03,19727,88.46
24,109.5,195,0.87,19922,89.34
24,106.5,191,0.86,20113,90.19
24,103.5,143,0.64,20256,90.83
24,100.5,183,0.82,20439,91.65
24,97.5,135,0.61,20574,92.26
24,94.5,106,0.48,20680,92.74
24,91.5,96,0.43,20776,93.17
24,88.5,101,0.45,20877,93.62
24,85.5,60,0.27,20937,93.89
24,82.5,70,0.31,21007,94.2
24,79.5,69,0.31,21076,94.51
24,76.5,72,0.32,21148,94.83
24,73.5,58,0.26,21206,95.09
24,70.5,40,0.18,21246,95.27
24,67.5,36,0.16,21282,95.43
24,64.5,26,0.12,21308,95.55
24,61.5,25,0.11,21333,95.66
24,58.5,27,0.12,21360,95.78
24,55.5,15,0.07,21375,95.85
24,52.5,18,0.08,21393,95.93
24,49.5,12,0.05,21405,95.99
24,46.5,13,0.06,21418,96.04
24,43.5,2,0.01,21420,96.05
24,40.5,11,0.05,21431,96.1
24,37.5,6,0.03,21437,96.13
24,34.5,7,0.03,21444,96.16
24,31.5,7,0.03,21451,96.19
24,28.5,1,0,21452,96.2
24,25.5,1,0,21453,96.2
24,22.5,2,0.01,21455,96.21
24,19.5,3,0.01,21458,96.22
24,16.5,4,0.02,21462,96.24
24,13.5,3,0.01,21465,96.26
24,10.5,3,0.01,21468,96.27
24,7.5,3,0.01,21471,96.28
24,4.5,0,0,21471,96.28
24,1.5,829,3.72,22300,100
25,398,0,0,0,0
25,394,0,0,0,0
25,390,0,0,0,0
25,386,0,0,0,0
25,382,1,0,1,0
25,378,1,0,2,0.01
25,374,2,0.01,4,0.02
25,370,3,0.01,7,0.03
25,366,13,0.06,20,0.09
25,362,30,0.14,50,0.23
25,358,33,0.15,83,0.38
25,354,45,0.2,128,0.58
25,350,78,0.35,206,0.94
25,346,92,0.42,298,1.36
25,342,118,0.54,416,1.89
25,338,160,0.73,576,2.62
25,334,199,0.9,775,3.52
25,330,246,1.12,1021,4.64
25,326,267,1.21,1288,5.86
25,322,332,1.51,1620,7.37
25,318,329,1.5,1949,8.86
25,314,363,1.65,2312,10.51
25,310,393,1.79,2705,12.3
25,306,430,1.96,3135,14.26
25,302,424,1.93,3559,16.18
25,298,417,1.9,3976,18.08
25,294,434,1.97,4410,20.05
25,290,476,2.16,4886,22.22
25,286,461,2.1,5347,24.31
25,282,466,2.12,5813,26.43
25,278,511,2.32,6324,28.76
25,274,453,2.06,6777,30.82
25,270,458,2.08,7235,32.9
25,266,477,2.17,7712,35.07
25,262,473,2.15,8185,37.22
25,258,459,2.09,8644,39.31
25,254,474,2.16,9118,41.46
25,250,506,2.3,9624,43.76
25,246,517,2.35,10141,46.11
25,242,472,2.15,10613,48.26
25,238,474,2.16,11087,50.42
25,234,514,2.34,11601,52.75
25,230,494,2.25,12095,55
25,226,477,2.17,12572,57.17
25,222,486,2.21,13058,59.38
25,218,423,1.92,13481,61.3
25,214,454,2.06,13935,63.37
25,210,522,2.37,14457,65.74
25,206,494,2.25,14951,67.99
25,202,434,1.97,15385,69.96
25,198,446,2.03,15831,71.99
25,194,432,1.96,16263,73.95
25,190,399,1.81,16662,75.77
25,186,396,1.8,17058,77.57
25,182,354,1.61,17412,79.18
25,178,345,1.57,17757,80.75
25,174,316,1.44,18073,82.18
25,170,320,1.46,18393,83.64
25,166,280,1.27,18673,84.91
25,162,232,1.05,18905,85.97
25,158,261,1.19,19166,87.15
25,154,201,0.91,19367,88.07
25,150,194,0.88,19561,88.95
25,146,212,0.96,19773,89.91
25,142,171,0.78,19944,90.69
25,138,130,0.59,20074,91.28
25,134,134,0.61,20208,91.89
25,130,126,0.57,20334,92.47
25,126,120,0.55,20454,93.01
25,122,92,0.42,20546,93.43
25,118,92,0.42,20638,93.85
25,114,69,0.31,20707,94.16
25,110,72,0.33,20779,94.49
25,106,44,0.2,20823,94.69
25,102,50,0.23,20873,94.92
25,98,41,0.19,20914,95.1
25,94,33,0.15,20947,95.25
25,90,28,0.13,20975,95.38
25,86,33,0.15,21008,95.53
25,82,23,0.1,21031,95.63
25,78,25,0.11,21056,95.75
25,74,20,0.09,21076,95.84
25,70,15,0.07,21091,95.91
25,66,12,0.05,21103,95.96
25,62,11,0.05,21114,96.01
25,58,12,0.05,21126,96.07
25,54,14,0.06,21140,96.13
25,50,8,0.04,21148,96.17
25,46,4,0.02,21152,96.18
25,42,6,0.03,21158,96.21
25,38,7,0.03,21165,96.24
25,34,3,0.01,21168,96.26
25,30,5,0.02,21173,96.28
25,26,0,0,21173,96.28
25,22,4,0.02,21177,96.3
25,18,3,0.01,21180,96.31
25,14,3,0.01,21183,96.33
25,10,3,0.01,21186,96.34
25,6,4,0.02,21190,96.36
25,2,801,3.64,21991,100
26,398,0,0,0,0
26,394,0,0,0,0
26,390,0,0,0,0
26,386,0,0,0,0
26,382,0,0,0,0
26,378,0,0,0,0
26,374,1,0,1,0
26,370,4,0.02,5,0.02
26,366,4,0.02,9,0.04
26,362,22,0.09,31,0.13
26,358,25,0.11,56,0.24
26,354,34,0.14,90,0.38
26,350,61,0.26,151,0.64
26,346,82,0.35,233,0.98
26,342,130,0.55,363,1.53
26,338,138,0.58,501,2.11
26,334,178,0.75,679,2.86
26,330,209,0.88,888,3.74
26,326,237,1,1125,4.74
26,322,292,1.23,1417,5.97
26,318,311,1.31,1728,7.29
26,314,356,1.5,2084,8.79
26,310,380,1.6,2464,10.39
26,306,382,1.61,2846,12
26,302,418,1.76,3264,13.76
26,298,398,1.68,3662,15.44
26,294,428,1.8,4090,17.24
26,290,477,2.01,4567,19.26
26,286,468,1.97,5035,21.23
26,282,454,1.91,5489,23.14
26,278,453,1.91,5942,25.05
26,274,496,2.09,6438,27.14
26,270,451,1.9,6889,29.05
26,266,496,2.09,7385,31.14
26,262,523,2.21,7908,33.34
26,258,539,2.27,8447,35.61
26,254,491,2.07,8938,37.68
26,250,488,2.06,9426,39.74
26,246,478,2.02,9904,41.76
26,242,497,2.1,10401,43.85
26,238,542,2.29,10943,46.14
26,234,508,2.14,11451,48.28
26,230,489,2.06,11940,50.34
26,226,493,2.08,12433,52.42
26,222,431,1.82,12864,54.24
26,218,523,2.21,13387,56.44
26,214,487,2.05,13874,58.5
26,210,565,2.38,14439,60.88
26,206,503,2.12,14942,63
26,202,519,2.19,15461,65.19
26,198,413,1.74,15874,66.93
26,194,488,2.06,16362,68.99
26,190,461,1.94,16823,70.93
26,186,477,2.01,17300,72.94
26,182,450,1.9,17750,74.84
26,178,421,1.78,18171,76.61
26,174,387,1.63,18558,78.24
26,170,359,1.51,18917,79.76
26,166,387,1.63,19304,81.39
26,162,374,1.58,19678,82.97
26,158,313,1.32,19991,84.29
26,154,290,1.22,20281,85.51
26,150,264,1.11,20545,86.62
26,146,235,0.99,20780,87.61
26,142,196,0.83,20976,88.44
26,138,210,0.89,21186,89.32
26,134,187,0.79,21373,90.11
26,130,161,0.68,21534,90.79
26,126,160,0.67,21694,91.47
26,122,165,0.7,21859,92.16
26,118,125,0.53,21984,92.69
26,114,115,0.48,22099,93.17
26,110,100,0.42,22199,93.6
26,106,90,0.38,22289,93.98
26,102,94,0.4,22383,94.37
26,98,69,0.29,22452,94.66
26,94,56,0.24,22508,94.9
26,90,53,0.22,22561,95.12
26,86,51,0.22,22612,95.34
26,82,36,0.15,22648,95.49
26,78,36,0.15,22684,95.64
26,74,34,0.14,22718,95.78
26,70,16,0.07,22734,95.85
26,66,18,0.08,22752,95.93
26,62,11,0.05,22763,95.97
26,58,13,0.05,22776,96.03
26,54,15,0.06,22791,96.09
26,50,10,0.04,22801,96.13
26,46,5,0.02,22806,96.15
26,42,8,0.03,22814,96.19
26,38,9,0.04,22823,96.23
26,34,3,0.01,22826,96.24
26,30,5,0.02,22831,96.26
26,26,1,0,22832,96.26
26,22,5,0.02,22837,96.29
26,18,4,0.02,22841,96.3
26,14,3,0.01,22844,96.32
26,10,3,0.01,22847,96.33
26,6,4,0.02,22851,96.34
26,2,867,3.66,23718,100
27,298.5,0,0,0,0
27,295.5,0,0,0,0
27,292.5,0,0,0,0
27,289.5,0,0,0,0
27,286.5,1,0,1,0
27,283.5,1,0,2,0.01
27,280.5,5,0.02,7,0.03
27,277.5,6,0.03,13,0.06
27,274.5,6,0.03,19,0.09
27,271.5,15,0.07,34,0.15
27,268.5,31,0.14,65,0.29
27,265.5,36,0.16,101,0.45
27,262.5,64,0.29,165,0.74
27,259.5,83,0.37,248,1.11
27,256.5,93,0.42,341,1.53
27,253.5,104,0.47,445,2
27,250.5,159,0.71,604,2.71
27,247.5,165,0.74,769,3.46
27,244.5,210,0.94,979,4.4
27,241.5,212,0.95,1191,5.35
27,238.5,270,1.21,1461,6.57
27,235.5,252,1.13,1713,7.7
27,232.5,292,1.31,2005,9.01
27,229.5,334,1.5,2339,10.51
27,226.5,373,1.68,2712,12.19
27,223.5,383,1.72,3095,13.91
27,220.5,378,1.7,3473,15.61
27,217.5,371,1.67,3844,17.28
27,214.5,438,1.97,4282,19.25
27,211.5,436,1.96,4718,21.21
27,208.5,425,1.91,5143,23.12
27,205.5,457,2.05,5600,25.17
27,202.5,447,2.01,6047,27.18
27,199.5,429,1.93,6476,29.11
27,196.5,486,2.18,6962,31.29
27,193.5,541,2.43,7503,33.72
27,190.5,446,2,7949,35.73
27,187.5,484,2.18,8433,37.9
27,184.5,451,2.03,8884,39.93
27,181.5,479,2.15,9363,42.08
27,178.5,513,2.31,9876,44.39
27,175.5,476,2.14,10352,46.53
27,172.5,460,2.07,10812,48.6
27,169.5,485,2.18,11297,50.78
27,166.5,446,2,11743,52.78
27,163.5,454,2.04,12197,54.82
27,160.5,406,1.82,12603,56.65
27,157.5,443,1.99,13046,58.64
27,154.5,418,1.88,13464,60.52
27,151.5,444,2,13908,62.51
27,148.5,397,1.78,14305,64.3
27,145.5,411,1.85,14716,66.14
27,142.5,358,1.61,15074,67.75
27,139.5,398,1.79,15472,69.54
27,136.5,359,1.61,15831,71.15
27,133.5,371,1.67,16202,72.82
27,130.5,382,1.72,16584,74.54
27,127.5,341,1.53,16925,76.07
27,124.5,318,1.43,17243,77.5
27,121.5,348,1.56,17591,79.06
27,118.5,318,1.43,17909,80.49
27,115.5,285,1.28,18194,81.77
27,112.5,289,1.3,18483,83.07
27,109.5,265,1.19,18748,84.26
27,106.5,316,1.42,19064,85.68
27,103.5,279,1.25,19343,86.94
27,100.5,225,1.01,19568,87.95
27,97.5,215,0.97,19783,88.92
27,94.5,207,0.93,19990,89.85
27,91.5,207,0.93,20197,90.78
27,88.5,159,0.71,20356,91.49
27,85.5,167,0.75,20523,92.24
27,82.5,150,0.67,20673,92.92
27,79.5,116,0.52,20789,93.44
27,76.5,89,0.4,20878,93.84
27,73.5,97,0.44,20975,94.27
27,70.5,79,0.36,21054,94.63
27,67.5,78,0.35,21132,94.98
27,64.5,53,0.24,21185,95.22
27,61.5,49,0.22,21234,95.44
27,58.5,25,0.11,21259,95.55
27,55.5,29,0.13,21288,95.68
27,52.5,19,0.09,21307,95.77
27,49.5,19,0.09,21326,95.85
27,46.5,17,0.08,21343,95.93
27,43.5,10,0.04,21353,95.97
27,40.5,13,0.06,21366,96.03
27,37.5,7,0.03,21373,96.06
27,34.5,4,0.02,21377,96.08
27,31.5,9,0.04,21386,96.12
27,28.5,9,0.04,21395,96.16
27,25.5,4,0.02,21399,96.18
27,22.5,7,0.03,21406,96.21
27,19.5,3,0.01,21409,96.22
27,16.5,6,0.03,21415,96.25
27,13.5,2,0.01,21417,96.26
27,10.5,3,0.01,21420,96.27
27,7.5,0,0,21420,96.27
27,4.5,0,0,21420,96.27
27,1.5,829,3.73,22249,100
28,398,0,0,0,0
28,394,0,0,0,0
28,390,0,0,0,0
28,386,0,0,0,0
28,382,0,0,0,0
28,378,1,0.01,1,0.01
28,374,1,0.01,2,0.01
28,370,2,0.01,4,0.03
28,366,6,0.04,10,0.07
28,362,10,0.07,20,0.14
28,358,20,0.14,40,0.28
28,354,38,0.26,78,0.54
28,350,48,0.33,126,0.87
28,346,66,0.45,192,1.32
28,342,96,0.66,288,1.98
28,338,97,0.67,385,2.65
28,334,132,0.91,517,3.56
28,330,178,1.23,695,4.79
28,326,183,1.26,878,6.05
28,322,183,1.26,1061,7.31
28,318,234,1.61,1295,8.92
28,314,233,1.61,1528,10.53
28,310,244,1.68,1772,12.21
28,306,266,1.83,2038,14.04
28,302,264,1.82,2302,15.86
28,298,250,1.72,2552,17.59
28,294,256,1.76,2808,19.35
28,290,266,1.83,3074,21.18
28,286,283,1.95,3357,23.13
28,282,277,1.91,3634,25.04
28,278,281,1.94,3915,26.98
28,274,282,1.94,4197,28.92
28,270,269,1.85,4466,30.77
28,266,305,2.1,4771,32.88
28,262,275,1.89,5046,34.77
28,258,279,1.92,5325,36.69
28,254,270,1.86,5595,38.55
28,250,317,2.18,5912,40.74
28,246,336,2.32,6248,43.05
28,242,280,1.93,6528,44.98
28,238,327,2.25,6855,47.24
28,234,275,1.89,7130,49.13
28,230,281,1.94,7411,51.07
28,226,247,1.7,7658,52.77
28,222,253,1.74,7911,54.51
28,218,262,1.81,8173,56.32
28,214,271,1.87,8444,58.19
28,210,277,1.91,8721,60.1
28,206,247,1.7,8968,61.8
28,202,282,1.94,9250,63.74
28,198,245,1.69,9495,65.43
28,194,247,1.7,9742,67.13
28,190,238,1.64,9980,68.77
28,186,238,1.64,10218,70.41
28,182,237,1.63,10455,72.04
28,178,221,1.52,10676,73.57
28,174,212,1.46,10888,75.03
28,170,200,1.38,11088,76.41
28,166,192,1.32,11280,77.73
28,162,191,1.32,11471,79.04
28,158,198,1.36,11669,80.41
28,154,181,1.25,11850,81.66
28,150,176,1.21,12026,82.87
28,146,198,1.36,12224,84.23
28,142,151,1.04,12375,85.27
28,138,140,0.96,12515,86.24
28,134,153,1.05,12668,87.29
28,130,147,1.01,12815,88.31
28,126,134,0.92,12949,89.23
28,122,106,0.73,13055,89.96
28,118,106,0.73,13161,90.69
28,114,102,0.7,13263,91.39
28,110,87,0.6,13350,91.99
28,106,80,0.55,13430,92.54
28,102,67,0.46,13497,93.01
28,98,61,0.42,13558,93.43
28,94,56,0.39,13614,93.81
28,90,47,0.32,13661,94.14
28,86,47,0.32,13708,94.46
28,82,41,0.28,13749,94.74
28,78,28,0.19,13777,94.94
28,74,27,0.19,13804,95.12
28,70,24,0.17,13828,95.29
28,66,15,0.1,13843,95.39
28,62,14,0.1,13857,95.49
28,58,9,0.06,13866,95.55
28,54,9,0.06,13875,95.61
28,50,3,0.02,13878,95.63
28,46,7,0.05,13885,95.68
28,42,4,0.03,13889,95.71
28,38,7,0.05,13896,95.76
28,34,7,0.05,13903,95.8
28,30,1,0.01,13904,95.81
28,26,6,0.04,13910,95.85
28,22,3,0.02,13913,95.87
28,18,3,0.02,13916,95.89
28,14,0,0,13916,95.89
28,10,1,0.01,13917,95.9
28,6,0,0,13917,95.9
28,2,595,4.1,14512,100
29,298.5,0,0,0,0
29,295.5,0,0,0,0
29,292.5,0,0,0,0
29,289.5,0,0,0,0
29,286.5,0,0,0,0
29,283.5,0,0,0,0
29,280.5,2,0.01,2,0.01
29,277.5,6,0.03,8,0.04
29,274.5,8,0.04,16,0.08
29,271.5,12,0.06,28,0.13
29,268.5,17,0.08,45,0.21
29,265.5,17,0.08,62,0.3
29,262.5,32,0.15,94,0.45
29,259.5,43,0.2,137,0.65
29,256.5,64,0.3,201,0.96
29,253.5,70,0.33,271,1.29
29,250.5,97,0.46,368,1.75
29,247.5,120,0.57,488,2.32
29,244.5,130,0.62,618,2.94
29,241.5,157,0.75,775,3.69
29,238.5,178,0.85,953,4.54
29,235.5,203,0.97,1156,5.51
29,232.5,262,1.25,1418,6.75
29,229.5,244,1.16,1662,7.92
29,226.5,254,1.21,1916,9.12
29,223.5,304,1.45,2220,10.57
29,220.5,309,1.47,2529,12.04
29,217.5,330,1.57,2859,13.62
29,214.5,361,1.72,3220,15.33
29,211.5,374,1.78,3594,17.12
29,208.5,398,1.9,3992,19.01
29,205.5,380,1.81,4372,20.82
29,202.5,430,2.05,4802,22.87
29,199.5,427,2.03,5229,24.9
29,196.5,427,2.03,5656,26.94
29,193.5,453,2.16,6109,29.09
29,190.5,415,1.98,6524,31.07
29,187.5,470,2.24,6994,33.31
29,184.5,490,2.33,7484,35.64
29,181.5,468,2.23,7952,37.87
29,178.5,499,2.38,8451,40.25
29,175.5,445,2.12,8896,42.37
29,172.5,475,2.26,9371,44.63
29,169.5,462,2.2,9833,46.83
29,166.5,502,2.39,10335,49.22
29,163.5,467,2.22,10802,51.44
29,160.5,489,2.33,11291,53.77
29,157.5,467,2.22,11758,56
29,154.5,452,2.15,12210,58.15
29,151.5,464,2.21,12674,60.36
29,148.5,439,2.09,13113,62.45
29,145.5,407,1.94,13520,64.39
29,142.5,406,1.93,13926,66.32
29,139.5,426,2.03,14352,68.35
29,136.5,386,1.84,14738,70.19
29,133.5,361,1.72,15099,71.91
29,130.5,368,1.75,15467,73.66
29,127.5,391,1.86,15858,75.52
29,124.5,380,1.81,16238,77.33
29,121.5,358,1.7,16596,79.04
29,118.5,347,1.65,16943,80.69
29,115.5,331,1.58,17274,82.26
29,112.5,281,1.34,17555,83.6
29,109.5,294,1.4,17849,85
29,106.5,288,1.37,18137,86.37
29,103.5,254,1.21,18391,87.58
29,100.5,255,1.21,18646,88.8
29,97.5,203,0.97,18849,89.77
29,94.5,181,0.86,19030,90.63
29,91.5,199,0.95,19229,91.58
29,88.5,164,0.78,19393,92.36
29,85.5,123,0.59,19516,92.94
29,82.5,115,0.55,19631,93.49
29,79.5,107,0.51,19738,94
29,76.5,89,0.42,19827,94.42
29,73.5,68,0.32,19895,94.75
29,70.5,59,0.28,19954,95.03
29,67.5,47,0.22,20001,95.25
29,64.5,44,0.21,20045,95.46
29,61.5,31,0.15,20076,95.61
29,58.5,31,0.15,20107,95.76
29,55.5,23,0.11,20130,95.87
29,52.5,19,0.09,20149,95.96
29,49.5,17,0.08,20166,96.04
29,46.5,11,0.05,20177,96.09
29,43.5,8,0.04,20185,96.13
29,40.5,7,0.03,20192,96.16
29,37.5,6,0.03,20198,96.19
29,34.5,6,0.03,20204,96.22
29,31.5,11,0.05,20215,96.27
29,28.5,3,0.01,20218,96.29
29,25.5,11,0.05,20229,96.34
29,22.5,8,0.04,20237,96.38
29,19.5,9,0.04,20246,96.42
29,16.5,3,0.01,20249,96.43
29,13.5,2,0.01,20251,96.44
29,10.5,1,0,20252,96.45
29,7.5,0,0,20252,96.45
29,4.5,0,0,20252,96.45
29,1.5,746,3.55,20998,100
30,398,0,0,0,0
30,394,0,0,0,0
30,390,0,0,0,0
30,386,0,0,0,0
30,382,0,0,0,0
30,378,0,0,0,0
30,374,4,0.02,4,0.02
30,370,3,0.01,7,0.03
30,366,15,0.07,22,0.11
30,362,15,0.07,37,0.18
30,358,20,0.1,57,0.28
30,354,32,0.16,89,0.43
30,350,43,0.21,132,0.64
30,346,74,0.36,206,1
30,342,83,0.4,289,1.4
30,338,110,0.53,399,1.94
30,334,126,0.61,525,2.55
30,330,156,0.76,681,3.31
30,326,158,0.77,839,4.07
30,322,205,1,1044,5.07
30,318,215,1.04,1259,6.11
30,314,240,1.16,1499,7.28
30,310,258,1.25,1757,8.53
30,306,287,1.39,2044,9.92
30,302,250,1.21,2294,11.13
30,298,299,1.45,2593,12.59
30,294,335,1.63,2928,14.21
30,290,361,1.75,3289,15.96
30,286,358,1.74,3647,17.7
30,282,364,1.77,4011,19.47
30,278,367,1.78,4378,21.25
30,274,362,1.76,4740,23.01
30,270,384,1.86,5124,24.87
30,266,466,2.26,5590,27.13
30,262,410,1.99,6000,29.12
30,258,413,2,6413,31.13
30,254,446,2.16,6859,33.29
30,250,429,2.08,7288,35.38
30,246,440,2.14,7728,37.51
30,242,403,1.96,8131,39.47
30,238,420,2.04,8551,41.51
30,234,441,2.14,8992,43.65
30,230,432,2.1,9424,45.74
30,226,410,1.99,9834,47.73
30,222,427,2.07,10261,49.81
30,218,394,1.91,10655,51.72
30,214,472,2.29,11127,54.01
30,210,397,1.93,11524,55.94
30,206,423,2.05,11947,57.99
30,202,395,1.92,12342,59.91
30,198,370,1.8,12712,61.7
30,194,356,1.73,13068,63.43
30,190,363,1.76,13431,65.19
30,186,365,1.77,13796,66.96
30,182,376,1.83,14172,68.79
30,178,366,1.78,14538,70.57
30,174,345,1.67,14883,72.24
30,170,336,1.63,15219,73.87
30,166,354,1.72,15573,75.59
30,162,336,1.63,15909,77.22
30,158,344,1.67,16253,78.89
30,154,313,1.52,16566,80.41
30,150,278,1.35,16844,81.76
30,146,280,1.36,17124,83.12
30,142,257,1.25,17381,84.37
30,138,296,1.44,17677,85.8
30,134,302,1.47,17979,87.27
30,130,225,1.09,18204,88.36
30,126,242,1.17,18446,89.53
30,122,177,0.86,18623,90.39
30,118,178,0.86,18801,91.26
30,114,145,0.7,18946,91.96
30,110,148,0.72,19094,92.68
30,106,145,0.7,19239,93.38
30,102,118,0.57,19357,93.96
30,98,78,0.38,19435,94.34
30,94,71,0.34,19506,94.68
30,90,62,0.3,19568,94.98
30,86,62,0.3,19630,95.28
30,82,47,0.23,19677,95.51
30,78,35,0.17,19712,95.68
30,74,38,0.18,19750,95.86
30,70,24,0.12,19774,95.98
30,66,14,0.07,19788,96.05
30,62,19,0.09,19807,96.14
30,58,11,0.05,19818,96.19
30,54,8,0.04,19826,96.23
30,50,9,0.04,19835,96.28
30,46,4,0.02,19839,96.3
30,42,10,0.05,19849,96.35
30,38,8,0.04,19857,96.38
30,34,8,0.04,19865,96.42
30,30,1,0,19866,96.43
30,26,3,0.01,19869,96.44
30,22,5,0.02,19874,96.47
30,18,2,0.01,19876,96.48
30,14,0,0,19876,96.48
30,10,0,0,19876,96.48
30,6,0,0,19876,96.48
30,2,726,3.52,20602,100
31,497.5,0,0,0,0
31,492.5,0,0,0,0
31,487.5,0,0,0,0
31,482.5,0,0,0,0
31,477.5,0,0,0,0
31,472.5,0,0,0,0
31,467.5,2,0.02,2,0.02
31,462.5,2,0.02,4,0.03
31,457.5,8,0.06,12,0.09
31,452.5,14,0.11,26,0.2
31,447.5,16,0.12,42,0.33
31,442.5,25,0.19,67,0.52
31,437.5,36,0.28,103,0.8
31,432.5,63,0.49,166,1.29
31,427.5,81,0.63,247,1.92
31,422.5,97,0.75,344,2.67
31,417.5,115,0.89,459,3.56
31,412.5,130,1.01,589,4.57
31,407.5,150,1.16,739,5.74
31,402.5,172,1.34,911,7.07
31,397.5,193,1.5,1104,8.57
31,392.5,199,1.55,1303,10.12
31,387.5,219,1.7,1522,11.82
31,382.5,186,1.44,1708,13.26
31,377.5,189,1.47,1897,14.73
31,372.5,219,1.7,2116,16.43
31,367.5,246,1.91,2362,18.34
31,362.5,237,1.84,2599,20.18
31,357.5,253,1.96,2852,22.14
31,352.5,233,1.81,3085,23.95
31,347.5,238,1.85,3323,25.8
31,342.5,223,1.73,3546,27.53
31,337.5,266,2.07,3812,29.6
31,332.5,269,2.09,4081,31.69
31,327.5,235,1.82,4316,33.51
31,322.5,251,1.95,4567,35.46
31,317.5,244,1.89,4811,37.36
31,312.5,256,1.99,5067,39.34
31,307.5,264,2.05,5331,41.39
31,302.5,253,1.96,5584,43.36
31,297.5,260,2.02,5844,45.38
31,292.5,239,1.86,6083,47.23
31,287.5,267,2.07,6350,49.31
31,282.5,273,2.12,6623,51.42
31,277.5,230,1.79,6853,53.21
31,272.5,239,1.86,7092,55.07
31,267.5,214,1.66,7306,56.73
31,262.5,232,1.8,7538,58.53
31,257.5,231,1.79,7769,60.32
31,252.5,248,1.93,8017,62.25
31,247.5,224,1.74,8241,63.99
31,242.5,229,1.78,8470,65.77
31,237.5,220,1.71,8690,67.47
31,232.5,232,1.8,8922,69.28
31,227.5,184,1.43,9106,70.7
31,222.5,213,1.65,9319,72.36
31,217.5,187,1.45,9506,73.81
31,212.5,180,1.4,9686,75.21
31,207.5,171,1.33,9857,76.54
31,202.5,192,1.49,10049,78.03
31,197.5,193,1.5,10242,79.52
31,192.5,166,1.29,10408,80.81
31,187.5,173,1.34,10581,82.16
31,182.5,181,1.41,10762,83.56
31,177.5,136,1.06,10898,84.62
31,172.5,166,1.29,11064,85.91
31,167.5,147,1.14,11211,87.05
31,162.5,122,0.95,11333,88
31,157.5,112,0.87,11445,88.87
31,152.5,100,0.78,11545,89.64
31,147.5,105,0.82,11650,90.46
31,142.5,107,0.83,11757,91.29
31,137.5,82,0.64,11839,91.92
31,132.5,65,0.5,11904,92.43
31,127.5,63,0.49,11967,92.92
31,122.5,68,0.53,12035,93.45
31,117.5,61,0.47,12096,93.92
31,112.5,50,0.39,12146,94.31
31,107.5,39,0.3,12185,94.61
31,102.5,21,0.16,12206,94.77
31,97.5,25,0.19,12231,94.97
31,92.5,24,0.19,12255,95.15
31,87.5,15,0.12,12270,95.27
31,82.5,18,0.14,12288,95.41
31,77.5,21,0.16,12309,95.57
31,72.5,12,0.09,12321,95.67
31,67.5,7,0.05,12328,95.72
31,62.5,7,0.05,12335,95.78
31,57.5,6,0.05,12341,95.82
31,52.5,10,0.08,12351,95.9
31,47.5,6,0.05,12357,95.95
31,42.5,3,0.02,12360,95.97
31,37.5,6,0.05,12366,96.02
31,32.5,2,0.02,12368,96.03
31,27.5,2,0.02,12370,96.05
31,22.5,2,0.02,12372,96.06
31,17.5,2,0.02,12374,96.08
31,12.5,0,0,12374,96.08
31,7.5,0,0,12374,96.08
31,2.5,505,3.92,12879,100
35,298.5,0,0,0,0
35,295.5,0,0,0,0
35,292.5,0,0,0,0
35,289.5,0,0,0,0
35,286.5,1,0,1,0
35,283.5,2,0.01,3,0.01
35,280.5,3,0.01,6,0.03
35,277.5,10,0.04,16,0.07
35,274.5,12,0.05,28,0.12
35,271.5,39,0.17,67,0.29
35,268.5,35,0.15,102,0.45
35,265.5,102,0.45,204,0.89
35,262.5,118,0.52,322,1.41
35,259.5,171,0.75,493,2.16
35,256.5,191,0.84,684,2.99
35,253.5,215,0.94,899,3.93
35,250.5,271,1.19,1170,5.12
35,247.5,303,1.33,1473,6.44
35,244.5,349,1.53,1822,7.97
35,241.5,386,1.69,2208,9.66
35,238.5,408,1.78,2616,11.44
35,235.5,422,1.85,3038,13.29
35,232.5,428,1.87,3466,15.16
35,229.5,437,1.91,3903,17.07
35,226.5,428,1.87,4331,18.94
35,223.5,438,1.92,4769,20.86
35,220.5,436,1.91,5205,22.76
35,217.5,436,1.91,5641,24.67
35,214.5,435,1.9,6076,26.57
35,211.5,448,1.96,6524,28.53
35,208.5,469,2.05,6993,30.58
35,205.5,440,1.92,7433,32.51
35,202.5,430,1.88,7863,34.39
35,199.5,385,1.68,8248,36.07
35,196.5,412,1.8,8660,37.87
35,193.5,447,1.95,9107,39.83
35,190.5,453,1.98,9560,41.81
35,187.5,487,2.13,10047,43.94
35,184.5,454,1.99,10501,45.92
35,181.5,395,1.73,10896,47.65
35,178.5,449,1.96,11345,49.62
35,175.5,477,2.09,11822,51.7
35,172.5,494,2.16,12316,53.86
35,169.5,476,2.08,12792,55.94
35,166.5,466,2.04,13258,57.98
35,163.5,481,2.1,13739,60.08
35,160.5,519,2.27,14258,62.35
35,157.5,466,2.04,14724,64.39
35,154.5,472,2.06,15196,66.46
35,151.5,506,2.21,15702,68.67
35,148.5,481,2.1,16183,70.77
35,145.5,440,1.92,16623,72.7
35,142.5,428,1.87,17051,74.57
35,139.5,428,1.87,17479,76.44
35,136.5,437,1.91,17916,78.35
35,133.5,411,1.8,18327,80.15
35,130.5,364,1.59,18691,81.74
35,127.5,364,1.59,19055,83.33
35,124.5,311,1.36,19366,84.69
35,121.5,299,1.31,19665,86
35,118.5,264,1.15,19929,87.16
35,115.5,254,1.11,20183,88.27
35,112.5,243,1.06,20426,89.33
35,109.5,197,0.86,20623,90.19
35,106.5,184,0.8,20807,91
35,103.5,122,0.53,20929,91.53
35,100.5,134,0.59,21063,92.11
35,97.5,124,0.54,21187,92.66
35,94.5,104,0.45,21291,93.11
35,91.5,118,0.52,21409,93.63
35,88.5,88,0.38,21497,94.01
35,85.5,65,0.28,21562,94.3
35,82.5,76,0.33,21638,94.63
35,79.5,59,0.26,21697,94.89
35,76.5,51,0.22,21748,95.11
35,73.5,39,0.17,21787,95.28
35,70.5,38,0.17,21825,95.45
35,67.5,24,0.1,21849,95.55
35,64.5,19,0.08,21868,95.64
35,61.5,22,0.1,21890,95.73
35,58.5,12,0.05,21902,95.78
35,55.5,15,0.07,21917,95.85
35,52.5,11,0.05,21928,95.9
35,49.5,7,0.03,21935,95.93
35,46.5,7,0.03,21942,95.96
35,43.5,8,0.03,21950,95.99
35,40.5,4,0.02,21954,96.01
35,37.5,4,0.02,21958,96.03
35,34.5,2,0.01,21960,96.04
35,31.5,2,0.01,21962,96.05
35,28.5,0,0,21962,96.05
35,25.5,0,0,21962,96.05
35,22.5,0,0,21962,96.05
35,19.5,0,0,21962,96.05
35,16.5,1,0,21963,96.05
35,13.5,1,0,21964,96.06
35,10.5,1,0,21965,96.06
35,7.5,1,0,21966,96.06
35,4.5,0,0,21966,96.06
35,1.5,900,3.94,22866,100
37,298.5,0,0,0,0
37,295.5,0,0,0,0
37,292.5,0,0,0,0
37,289.5,0,0,0,0
37,286.5,0,0,0,0
37,283.5,2,0.01,2,0.01
37,280.5,2,0.01,4,0.03
37,277.5,10,0.06,14,0.09
37,274.5,19,0.12,33,0.21
37,271.5,32,0.21,65,0.42
37,268.5,50,0.32,115,0.74
37,265.5,96,0.62,211,1.36
37,262.5,141,0.91,352,2.27
37,259.5,206,1.33,558,3.6
37,256.5,248,1.6,806,5.2
37,253.5,279,1.8,1085,7
37,250.5,341,2.2,1426,9.2
37,247.5,313,2.02,1739,11.22
37,244.5,312,2.01,2051,13.23
37,241.5,315,2.03,2366,15.26
37,238.5,363,2.34,2729,17.61
37,235.5,339,2.19,3068,19.79
37,232.5,359,2.32,3427,22.11
37,229.5,332,2.14,3759,24.25
37,226.5,334,2.15,4093,26.4
37,223.5,308,1.99,4401,28.39
37,220.5,298,1.92,4699,30.31
37,217.5,307,1.98,5006,32.29
37,214.5,320,2.06,5326,34.36
37,211.5,297,1.92,5623,36.28
37,208.5,302,1.95,5925,38.22
37,205.5,283,1.83,6208,40.05
37,202.5,279,1.8,6487,41.85
37,199.5,280,1.81,6767,43.66
37,196.5,298,1.92,7065,45.58
37,193.5,270,1.74,7335,47.32
37,190.5,267,1.72,7602,49.04
37,187.5,262,1.69,7864,50.73
37,184.5,272,1.75,8136,52.49
37,181.5,255,1.65,8391,54.13
37,178.5,261,1.68,8652,55.82
37,175.5,258,1.66,8910,57.48
37,172.5,258,1.66,9168,59.14
37,169.5,271,1.75,9439,60.89
37,166.5,264,1.7,9703,62.6
37,163.5,259,1.67,9962,64.27
37,160.5,265,1.71,10227,65.98
37,157.5,246,1.59,10473,67.56
37,154.5,249,1.61,10722,69.17
37,151.5,243,1.57,10965,70.74
37,148.5,240,1.55,11205,72.29
37,145.5,205,1.32,11410,73.61
37,142.5,188,1.21,11598,74.82
37,139.5,187,1.21,11785,76.03
37,136.5,208,1.34,11993,77.37
37,133.5,206,1.33,12199,78.7
37,130.5,184,1.19,12383,79.89
37,127.5,190,1.23,12573,81.11
37,124.5,182,1.17,12755,82.29
37,121.5,182,1.17,12937,83.46
37,118.5,161,1.04,13098,84.5
37,115.5,155,1,13253,85.5
37,112.5,166,1.07,13419,86.57
37,109.5,126,0.81,13545,87.38
37,106.5,139,0.9,13684,88.28
37,103.5,137,0.88,13821,89.16
37,100.5,116,0.75,13937,89.91
37,97.5,109,0.7,14046,90.61
37,94.5,90,0.58,14136,91.19
37,91.5,87,0.56,14223,91.76
37,88.5,71,0.46,14294,92.21
37,85.5,63,0.41,14357,92.62
37,82.5,58,0.37,14415,92.99
37,79.5,56,0.36,14471,93.36
37,76.5,54,0.35,14525,93.7
37,73.5,36,0.23,14561,93.94
37,70.5,42,0.27,14603,94.21
37,67.5,32,0.21,14635,94.41
37,64.5,31,0.2,14666,94.61
37,61.5,25,0.16,14691,94.77
37,58.5,21,0.14,14712,94.91
37,55.5,17,0.11,14729,95.02
37,52.5,11,0.07,14740,95.09
37,49.5,15,0.1,14755,95.19
37,46.5,3,0.02,14758,95.21
37,43.5,3,0.02,14761,95.23
37,40.5,8,0.05,14769,95.28
37,37.5,0,0,14769,95.28
37,34.5,2,0.01,14771,95.29
37,31.5,3,0.02,14774,95.31
37,28.5,2,0.01,14776,95.32
37,25.5,5,0.03,14781,95.36
37,22.5,4,0.03,14785,95.38
37,19.5,3,0.02,14788,95.4
37,16.5,2,0.01,14790,95.41
37,13.5,1,0.01,14791,95.42
37,10.5,1,0.01,14792,95.43
37,7.5,1,0.01,14793,95.43
37,4.5,0,0,14793,95.43
37,1.5,708,4.57,15501,100
39,298.5,0,0,0,0
39,295.5,0,0,0,0
39,292.5,0,0,0,0
39,289.5,0,0,0,0
39,286.5,0,0,0,0
39,283.5,2,0.01,2,0.01
39,280.5,14,0.06,16,0.07
39,277.5,22,0.1,38,0.17
39,274.5,27,0.12,65,0.29
39,271.5,55,0.24,120,0.53
39,268.5,79,0.35,199,0.89
39,265.5,127,0.57,326,1.45
39,262.5,175,0.78,501,2.23
39,259.5,208,0.93,709,3.16
39,256.5,258,1.15,967,4.3
39,253.5,284,1.26,1251,5.57
39,250.5,341,1.52,1592,7.09
39,247.5,385,1.71,1977,8.8
39,244.5,427,1.9,2404,10.7
39,241.5,398,1.77,2802,12.47
39,238.5,425,1.89,3227,14.36
39,235.5,404,1.8,3631,16.16
39,232.5,464,2.07,4095,18.23
39,229.5,473,2.11,4568,20.33
39,226.5,485,2.16,5053,22.49
39,223.5,439,1.95,5492,24.45
39,220.5,459,2.04,5951,26.49
39,217.5,442,1.97,6393,28.46
39,214.5,443,1.97,6836,30.43
39,211.5,450,2,7286,32.43
39,208.5,459,2.04,7745,34.47
39,205.5,451,2.01,8196,36.48
39,202.5,441,1.96,8637,38.44
39,199.5,464,2.07,9101,40.51
39,196.5,476,2.12,9577,42.63
39,193.5,373,1.66,9950,44.29
39,190.5,407,1.81,10357,46.1
39,187.5,394,1.75,10751,47.85
39,184.5,437,1.95,11188,49.8
39,181.5,392,1.74,11580,51.54
39,178.5,434,1.93,12014,53.48
39,175.5,403,1.79,12417,55.27
39,172.5,402,1.79,12819,57.06
39,169.5,382,1.7,13201,58.76
39,166.5,400,1.78,13601,60.54
39,163.5,380,1.69,13981,62.23
39,160.5,337,1.5,14318,63.73
39,157.5,373,1.66,14691,65.39
39,154.5,335,1.49,15026,66.88
39,151.5,348,1.55,15374,68.43
39,148.5,376,1.67,15750,70.11
39,145.5,346,1.54,16096,71.65
39,142.5,331,1.47,16427,73.12
39,139.5,316,1.41,16743,74.53
39,136.5,321,1.43,17064,75.95
39,133.5,267,1.19,17331,77.14
39,130.5,312,1.39,17643,78.53
39,127.5,313,1.39,17956,79.93
39,124.5,295,1.31,18251,81.24
39,121.5,302,1.34,18553,82.58
39,118.5,280,1.25,18833,83.83
39,115.5,244,1.09,19077,84.91
39,112.5,233,1.04,19310,85.95
39,109.5,271,1.21,19581,87.16
39,106.5,258,1.15,19839,88.31
39,103.5,234,1.04,20073,89.35
39,100.5,194,0.86,20267,90.21
39,97.5,177,0.79,20444,91
39,94.5,168,0.75,20612,91.75
39,91.5,150,0.67,20762,92.42
39,88.5,152,0.68,20914,93.09
39,85.5,112,0.5,21026,93.59
39,82.5,91,0.41,21117,94
39,79.5,96,0.43,21213,94.42
39,76.5,70,0.31,21283,94.73
39,73.5,46,0.2,21329,94.94
39,70.5,50,0.22,21379,95.16
39,67.5,53,0.24,21432,95.4
39,64.5,30,0.13,21462,95.53
39,61.5,32,0.14,21494,95.67
39,58.5,15,0.07,21509,95.74
39,55.5,15,0.07,21524,95.81
39,52.5,16,0.07,21540,95.88
39,49.5,11,0.05,21551,95.93
39,46.5,7,0.03,21558,95.96
39,43.5,5,0.02,21563,95.98
39,40.5,3,0.01,21566,95.99
39,37.5,6,0.03,21572,96.02
39,34.5,3,0.01,21575,96.03
39,31.5,6,0.03,21581,96.06
39,28.5,5,0.02,21586,96.08
39,25.5,6,0.03,21592,96.11
39,22.5,4,0.02,21596,96.13
39,19.5,4,0.02,21600,96.15
39,16.5,3,0.01,21603,96.16
39,13.5,3,0.01,21606,96.17
39,10.5,4,0.02,21610,96.19
39,7.5,2,0.01,21612,96.2
39,4.5,0,0,21612,96.2
39,1.5,854,3.8,22466,100
40,398,0,0,0,0
40,394,0,0,0,0
40,390,0,0,0,0
40,386,0,0,0,0
40,382,0,0,0,0
40,378,0,0,0,0
40,374,7,0.05,7,0.05
40,370,8,0.05,15,0.1
40,366,18,0.12,33,0.22
40,362,37,0.25,70,0.48
40,358,62,0.42,132,0.9
40,354,95,0.65,227,1.54
40,350,140,0.95,367,2.5
40,346,158,1.08,525,3.57
40,342,212,1.44,737,5.02
40,338,234,1.59,971,6.61
40,334,241,1.64,1212,8.25
40,330,296,2.01,1508,10.26
40,326,296,2.01,1804,12.28
40,322,308,2.1,2112,14.37
40,318,304,2.07,2416,16.44
40,314,282,1.92,2698,18.36
40,310,283,1.93,2981,20.29
40,306,303,2.06,3284,22.35
40,302,296,2.01,3580,24.37
40,298,287,1.95,3867,26.32
40,294,312,2.12,4179,28.44
40,290,282,1.92,4461,30.36
40,286,279,1.9,4740,32.26
40,282,295,2.01,5035,34.27
40,278,263,1.79,5298,36.06
40,274,257,1.75,5555,37.81
40,270,278,1.89,5833,39.7
40,266,296,2.01,6129,41.71
40,262,261,1.78,6390,43.49
40,258,268,1.82,6658,45.31
40,254,269,1.83,6927,47.14
40,250,284,1.93,7211,49.08
40,246,276,1.88,7487,50.96
40,242,254,1.73,7741,52.68
40,238,252,1.72,7993,54.4
40,234,233,1.59,8226,55.99
40,230,263,1.79,8489,57.78
40,226,262,1.78,8751,59.56
40,222,265,1.8,9016,61.36
40,218,219,1.49,9235,62.85
40,214,241,1.64,9476,64.49
40,210,215,1.46,9691,65.96
40,206,247,1.68,9938,67.64
40,202,220,1.5,10158,69.13
40,198,199,1.35,10357,70.49
40,194,207,1.41,10564,71.9
40,190,200,1.36,10764,73.26
40,186,195,1.33,10959,74.59
40,182,171,1.16,11130,75.75
40,178,197,1.34,11327,77.09
40,174,183,1.25,11510,78.34
40,170,191,1.3,11701,79.64
40,166,183,1.25,11884,80.88
40,162,177,1.2,12061,82.09
40,158,171,1.16,12232,83.25
40,154,168,1.14,12400,84.39
40,150,169,1.15,12569,85.54
40,146,149,1.01,12718,86.56
40,142,138,0.94,12856,87.5
40,138,125,0.85,12981,88.35
40,134,111,0.76,13092,89.1
40,130,118,0.8,13210,89.91
40,126,109,0.74,13319,90.65
40,122,100,0.68,13419,91.33
40,118,91,0.62,13510,91.95
40,114,91,0.62,13601,92.57
40,110,73,0.5,13674,93.06
40,106,60,0.41,13734,93.47
40,102,55,0.37,13789,93.85
40,98,41,0.28,13830,94.13
40,94,37,0.25,13867,94.38
40,90,37,0.25,13904,94.63
40,86,32,0.22,13936,94.85
40,82,24,0.16,13960,95.01
40,78,32,0.22,13992,95.23
40,74,16,0.11,14008,95.34
40,70,11,0.07,14019,95.41
40,66,11,0.07,14030,95.49
40,62,7,0.05,14037,95.54
40,58,5,0.03,14042,95.57
40,54,6,0.04,14048,95.61
40,50,3,0.02,14051,95.63
40,46,5,0.03,14056,95.66
40,42,1,0.01,14057,95.67
40,38,2,0.01,14059,95.69
40,34,5,0.03,14064,95.72
40,30,0,0,14064,95.72
40,26,7,0.05,14071,95.77
40,22,1,0.01,14072,95.77
40,18,3,0.02,14075,95.79
40,14,0,0,14075,95.79
40,10,2,0.01,14077,95.81
40,6,0,0,14077,95.81
40,2,616,4.19,14693,100
42,298.5,0,0,0,0
42,295.5,0,0,0,0
42,292.5,0,0,0,0
42,289.5,0,0,0,0
42,286.5,0,0,0,0
42,283.5,0,0,0,0
42,280.5,3,0.01,3,0.01
42,277.5,13,0.06,16,0.08
42,274.5,10,0.05,26,0.12
42,271.5,27,0.13,53,0.25
42,268.5,44,0.21,97,0.46
42,265.5,48,0.23,145,0.69
42,262.5,77,0.36,222,1.05
42,259.5,95,0.45,317,1.5
42,256.5,145,0.69,462,2.18
42,253.5,206,0.97,668,3.16
42,250.5,247,1.17,915,4.32
42,247.5,252,1.19,1167,5.52
42,244.5,301,1.42,1468,6.94
42,241.5,306,1.45,1774,8.38
42,238.5,363,1.72,2137,10.1
42,235.5,391,1.85,2528,11.95
42,232.5,384,1.81,2912,13.76
42,229.5,426,2.01,3338,15.78
42,226.5,407,1.92,3745,17.7
42,223.5,439,2.07,4184,19.78
42,220.5,401,1.9,4585,21.67
42,217.5,412,1.95,4997,23.62
42,214.5,399,1.89,5396,25.5
42,211.5,433,2.05,5829,27.55
42,208.5,443,2.09,6272,29.64
42,205.5,418,1.98,6690,31.62
42,202.5,427,2.02,7117,33.64
42,199.5,490,2.32,7607,35.95
42,196.5,474,2.24,8081,38.19
42,193.5,444,2.1,8525,40.29
42,190.5,460,2.17,8985,42.47
42,187.5,452,2.14,9437,44.6
42,184.5,429,2.03,9866,46.63
42,181.5,360,1.7,10226,48.33
42,178.5,428,2.02,10654,50.35
42,175.5,411,1.94,11065,52.3
42,172.5,441,2.08,11506,54.38
42,169.5,440,2.08,11946,56.46
42,166.5,418,1.98,12364,58.44
42,163.5,375,1.77,12739,60.21
42,160.5,447,2.11,13186,62.32
42,157.5,368,1.74,13554,64.06
42,154.5,340,1.61,13894,65.67
42,151.5,397,1.88,14291,67.54
42,148.5,352,1.66,14643,69.21
42,145.5,344,1.63,14987,70.83
42,142.5,358,1.69,15345,72.53
42,139.5,333,1.57,15678,74.1
42,136.5,313,1.48,15991,75.58
42,133.5,303,1.43,16294,77.01
42,130.5,306,1.45,16600,78.46
42,127.5,310,1.47,16910,79.92
42,124.5,321,1.52,17231,81.44
42,121.5,299,1.41,17530,82.85
42,118.5,314,1.48,17844,84.34
42,115.5,276,1.3,18120,85.64
42,112.5,251,1.19,18371,86.83
42,109.5,242,1.14,18613,87.97
42,106.5,216,1.02,18829,88.99
42,103.5,215,1.02,19044,90.01
42,100.5,188,0.89,19232,90.9
42,97.5,176,0.83,19408,91.73
42,94.5,171,0.81,19579,92.54
42,91.5,127,0.6,19706,93.14
42,88.5,99,0.47,19805,93.61
42,85.5,95,0.45,19900,94.05
42,82.5,79,0.37,19979,94.43
42,79.5,69,0.33,20048,94.75
42,76.5,64,0.3,20112,95.06
42,73.5,48,0.23,20160,95.28
42,70.5,41,0.19,20201,95.48
42,67.5,26,0.12,20227,95.6
42,64.5,32,0.15,20259,95.75
42,61.5,19,0.09,20278,95.84
42,58.5,14,0.07,20292,95.91
42,55.5,16,0.08,20308,95.98
42,52.5,12,0.06,20320,96.04
42,49.5,6,0.03,20326,96.07
42,46.5,7,0.03,20333,96.1
42,43.5,3,0.01,20336,96.11
42,40.5,1,0,20337,96.12
42,37.5,5,0.02,20342,96.14
42,34.5,5,0.02,20347,96.17
42,31.5,6,0.03,20353,96.2
42,28.5,3,0.01,20356,96.21
42,25.5,9,0.04,20365,96.25
42,22.5,6,0.03,20371,96.28
42,19.5,10,0.05,20381,96.33
42,16.5,4,0.02,20385,96.35
42,13.5,2,0.01,20387,96.36
42,10.5,1,0,20388,96.36
42,7.5,1,0,20389,96.37
42,4.5,0,0,20389,96.37
42,1.5,769,3.63,21158,100
43,398,0,0,0,0
43,394,0,0,0,0
43,390,0,0,0,0
43,386,0,0,0,0
43,382,0,0,0,0
43,378,0,0,0,0
43,374,1,0.01,1,0.01
43,370,3,0.02,4,0.03
43,366,9,0.07,13,0.1
43,362,21,0.16,34,0.26
43,358,25,0.19,59,0.45
43,354,48,0.37,107,0.82
43,350,68,0.52,175,1.34
43,346,98,0.75,273,2.09
43,342,128,0.98,401,3.06
43,338,164,1.25,565,4.32
43,334,186,1.42,751,5.74
43,330,218,1.67,969,7.4
43,326,224,1.71,1193,9.12
43,322,221,1.69,1414,10.81
43,318,271,2.07,1685,12.88
43,314,272,2.08,1957,14.95
43,310,266,2.03,2223,16.99
43,306,252,1.93,2475,18.91
43,302,266,2.03,2741,20.95
43,298,249,1.9,2990,22.85
43,294,264,2.02,3254,24.87
43,290,264,2.02,3518,26.88
43,286,249,1.9,3767,28.79
43,282,281,2.15,4048,30.93
43,278,238,1.82,4286,32.75
43,274,264,2.02,4550,34.77
43,270,259,1.98,4809,36.75
43,266,244,1.86,5053,38.61
43,262,308,2.35,5361,40.97
43,258,248,1.9,5609,42.86
43,254,261,1.99,5870,44.86
43,250,244,1.86,6114,46.72
43,246,252,1.93,6366,48.65
43,242,275,2.1,6641,50.75
43,238,270,2.06,6911,52.81
43,234,257,1.96,7168,54.78
43,230,254,1.94,7422,56.72
43,226,245,1.87,7667,58.59
43,222,242,1.85,7909,60.44
43,218,239,1.83,8148,62.27
43,214,215,1.64,8363,63.91
43,210,200,1.53,8563,65.44
43,206,204,1.56,8767,67
43,202,232,1.77,8999,68.77
43,198,207,1.58,9206,70.35
43,194,186,1.42,9392,71.77
43,190,185,1.41,9577,73.19
43,186,190,1.45,9767,74.64
43,182,193,1.47,9960,76.11
43,178,173,1.32,10133,77.43
43,174,166,1.27,10299,78.7
43,170,182,1.39,10481,80.09
43,166,161,1.23,10642,81.32
43,162,175,1.34,10817,82.66
43,158,166,1.27,10983,83.93
43,154,163,1.25,11146,85.17
43,150,165,1.26,11311,86.44
43,146,122,0.93,11433,87.37
43,142,125,0.96,11558,88.32
43,138,86,0.66,11644,88.98
43,134,104,0.79,11748,89.78
43,130,112,0.86,11860,90.63
43,126,85,0.65,11945,91.28
43,122,72,0.55,12017,91.83
43,118,84,0.64,12101,92.47
43,114,70,0.53,12171,93.01
43,110,47,0.36,12218,93.37
43,106,50,0.38,12268,93.75
43,102,43,0.33,12311,94.08
43,98,37,0.28,12348,94.36
43,94,36,0.28,12384,94.64
43,90,31,0.24,12415,94.87
43,86,23,0.18,12438,95.05
43,82,22,0.17,12460,95.22
43,78,21,0.16,12481,95.38
43,74,18,0.14,12499,95.51
43,70,9,0.07,12508,95.58
43,66,6,0.05,12514,95.63
43,62,5,0.04,12519,95.67
43,58,7,0.05,12526,95.72
43,54,7,0.05,12533,95.77
43,50,4,0.03,12537,95.8
43,46,6,0.05,12543,95.85
43,42,1,0.01,12544,95.86
43,38,1,0.01,12545,95.87
43,34,3,0.02,12548,95.89
43,30,1,0.01,12549,95.9
43,26,2,0.02,12551,95.91
43,22,2,0.02,12553,95.93
43,18,1,0.01,12554,95.93
43,14,2,0.02,12556,95.95
43,10,2,0.02,12558,95.97
43,6,0,0,12558,95.97
43,2,528,4.03,13086,100
44,398,0,0,0,0
44,394,0,0,0,0
44,390,0,0,0,0
44,386,0,0,0,0
44,382,0,0,0,0
44,378,0,0,0,0
44,374,6,0.03,6,0.03
44,370,10,0.05,16,0.08
44,366,17,0.08,33,0.16
44,362,35,0.17,68,0.33
44,358,54,0.26,122,0.59
44,354,61,0.29,183,0.88
44,350,83,0.4,266,1.28
44,346,127,0.61,393,1.9
44,342,178,0.86,571,2.76
44,338,191,0.92,762,3.68
44,334,245,1.18,1007,4.86
44,330,247,1.19,1254,6.05
44,326,286,1.38,1540,7.43
44,322,303,1.46,1843,8.9
44,318,326,1.57,2169,10.47
44,314,352,1.7,2521,12.17
44,310,367,1.77,2888,13.94
44,306,368,1.78,3256,15.72
44,302,363,1.75,3619,17.47
44,298,386,1.86,4005,19.33
44,294,384,1.85,4389,21.18
44,290,372,1.8,4761,22.98
44,286,398,1.92,5159,24.9
44,282,359,1.73,5518,26.63
44,278,419,2.02,5937,28.65
44,274,412,1.99,6349,30.64
44,270,443,2.14,6792,32.78
44,266,416,2.01,7208,34.79
44,262,403,1.95,7611,36.73
44,258,447,2.16,8058,38.89
44,254,445,2.15,8503,41.04
44,250,375,1.81,8878,42.85
44,246,418,2.02,9296,44.87
44,242,406,1.96,9702,46.83
44,238,425,2.05,10127,48.88
44,234,417,2.01,10544,50.89
44,230,419,2.02,10963,52.91
44,226,367,1.77,11330,54.68
44,222,357,1.72,11687,56.41
44,218,369,1.78,12056,58.19
44,214,349,1.68,12405,59.87
44,210,343,1.66,12748,61.53
44,206,382,1.84,13130,63.37
44,202,328,1.58,13458,64.95
44,198,321,1.55,13779,66.5
44,194,344,1.66,14123,68.16
44,190,325,1.57,14448,69.73
44,186,318,1.53,14766,71.27
44,182,322,1.55,15088,72.82
44,178,321,1.55,15409,74.37
44,174,327,1.58,15736,75.95
44,170,298,1.44,16034,77.39
44,166,308,1.49,16342,78.87
44,162,298,1.44,16640,80.31
44,158,309,1.49,16949,81.8
44,154,274,1.32,17223,83.13
44,150,300,1.45,17523,84.57
44,146,255,1.23,17778,85.81
44,142,237,1.14,18015,86.95
44,138,245,1.18,18260,88.13
44,134,240,1.16,18500,89.29
44,130,201,0.97,18701,90.26
44,126,174,0.84,18875,91.1
44,122,157,0.76,19032,91.86
44,118,156,0.75,19188,92.61
44,114,146,0.7,19334,93.32
44,110,103,0.5,19437,93.81
44,106,91,0.44,19528,94.25
44,102,96,0.46,19624,94.71
44,98,75,0.36,19699,95.08
44,94,42,0.2,19741,95.28
44,90,37,0.18,19778,95.46
44,86,29,0.14,19807,95.6
44,82,34,0.16,19841,95.76
44,78,30,0.14,19871,95.91
44,74,19,0.09,19890,96
44,70,20,0.1,19910,96.1
44,66,10,0.05,19920,96.14
44,62,6,0.03,19926,96.17
44,58,7,0.03,19933,96.21
44,54,7,0.03,19940,96.24
44,50,9,0.04,19949,96.28
44,46,3,0.01,19952,96.3
44,42,5,0.02,19957,96.32
44,38,3,0.01,19960,96.34
44,34,4,0.02,19964,96.36
44,30,0,0,19964,96.36
44,26,4,0.02,19968,96.38
44,22,5,0.02,19973,96.4
44,18,2,0.01,19975,96.41
44,14,1,0,19976,96.41
44,10,1,0,19977,96.42
44,6,0,0,19977,96.42
44,2,742,3.58,20719,100
45,497.5,0,0,0,0
45,492.5,0,0,0,0
45,487.5,0,0,0,0
45,482.5,0,0,0,0
45,477.5,0,0,0,0
45,472.5,0,0,0,0
45,467.5,1,0.01,1,0.01
45,462.5,8,0.06,9,0.07
45,457.5,10,0.08,19,0.15
45,452.5,19,0.15,38,0.29
45,447.5,42,0.32,80,0.62
45,442.5,66,0.51,146,1.13
45,437.5,78,0.6,224,1.73
45,432.5,104,0.8,328,2.53
45,427.5,142,1.09,470,3.62
45,422.5,178,1.37,648,5
45,417.5,193,1.49,841,6.48
45,412.5,198,1.53,1039,8.01
45,407.5,203,1.56,1242,9.57
45,402.5,235,1.81,1477,11.39
45,397.5,242,1.87,1719,13.25
45,392.5,271,2.09,1990,15.34
45,387.5,249,1.92,2239,17.26
45,382.5,234,1.8,2473,19.06
45,377.5,252,1.94,2725,21.01
45,372.5,250,1.93,2975,22.93
45,367.5,243,1.87,3218,24.81
45,362.5,244,1.88,3462,26.69
45,357.5,266,2.05,3728,28.74
45,352.5,274,2.11,4002,30.85
45,347.5,255,1.97,4257,32.82
45,342.5,240,1.85,4497,34.67
45,337.5,256,1.97,4753,36.64
45,332.5,233,1.8,4986,38.44
45,327.5,232,1.79,5218,40.23
45,322.5,273,2.1,5491,42.33
45,317.5,249,1.92,5740,44.25
45,312.5,236,1.82,5976,46.07
45,307.5,246,1.9,6222,47.96
45,302.5,247,1.9,6469,49.87
45,297.5,260,2,6729,51.87
45,292.5,236,1.82,6965,53.69
45,287.5,222,1.71,7187,55.4
45,282.5,229,1.77,7416,57.17
45,277.5,238,1.83,7654,59
45,272.5,209,1.61,7863,60.62
45,267.5,234,1.8,8097,62.42
45,262.5,212,1.63,8309,64.05
45,257.5,187,1.44,8496,65.49
45,252.5,202,1.56,8698,67.05
45,247.5,189,1.46,8887,68.51
45,242.5,180,1.39,9067,69.9
45,237.5,168,1.3,9235,71.19
45,232.5,192,1.48,9427,72.67
45,227.5,183,1.41,9610,74.08
45,222.5,178,1.37,9788,75.45
45,217.5,181,1.4,9969,76.85
45,212.5,181,1.4,10150,78.25
45,207.5,175,1.35,10325,79.59
45,202.5,155,1.19,10480,80.79
45,197.5,156,1.2,10636,81.99
45,192.5,161,1.24,10797,83.23
45,187.5,148,1.14,10945,84.37
45,182.5,149,1.15,11094,85.52
45,177.5,134,1.03,11228,86.56
45,172.5,139,1.07,11367,87.63
45,167.5,113,0.87,11480,88.5
45,162.5,114,0.88,11594,89.38
45,157.5,96,0.74,11690,90.12
45,152.5,108,0.83,11798,90.95
45,147.5,94,0.72,11892,91.67
45,142.5,87,0.67,11979,92.35
45,137.5,71,0.55,12050,92.89
45,132.5,54,0.42,12104,93.31
45,127.5,52,0.4,12156,93.71
45,122.5,46,0.35,12202,94.06
45,117.5,47,0.36,12249,94.43
45,112.5,35,0.27,12284,94.7
45,107.5,31,0.24,12315,94.94
45,102.5,30,0.23,12345,95.17
45,97.5,24,0.19,12369,95.35
45,92.5,14,0.11,12383,95.46
45,87.5,12,0.09,12395,95.55
45,82.5,11,0.08,12406,95.64
45,77.5,8,0.06,12414,95.7
45,72.5,9,0.07,12423,95.77
45,67.5,3,0.02,12426,95.79
45,62.5,5,0.04,12431,95.83
45,57.5,4,0.03,12435,95.86
45,52.5,3,0.02,12438,95.88
45,47.5,4,0.03,12442,95.91
45,42.5,2,0.02,12444,95.93
45,37.5,1,0.01,12445,95.94
45,32.5,2,0.02,12447,95.95
45,27.5,3,0.02,12450,95.98
45,22.5,1,0.01,12451,95.98
45,17.5,1,0.01,12452,95.99
45,12.5,1,0.01,12453,96
45,7.5,1,0.01,12454,96.01
45,2.5,518,3.99,12972,100
46,298.5,0,0,0,0
46,295.5,0,0,0,0
46,292.5,0,0,0,0
46,289.5,0,0,0,0
46,286.5,0,0,0,0
46,283.5,1,0,1,0
46,280.5,2,0.01,3,0.01
46,277.5,4,0.02,7,0.03
46,274.5,10,0.04,17,0.07
46,271.5,28,0.11,45,0.18
46,268.5,26,0.11,71,0.29
46,265.5,63,0.26,134,0.54
46,262.5,84,0.34,218,0.89
46,259.5,107,0.43,325,1.32
46,256.5,165,0.67,490,1.99
46,253.5,213,0.87,703,2.86
46,250.5,229,0.93,932,3.79
46,247.5,291,1.18,1223,4.97
46,244.5,310,1.26,1533,6.23
46,241.5,307,1.25,1840,7.48
46,238.5,322,1.31,2162,8.79
46,235.5,391,1.59,2553,10.38
46,232.5,409,1.66,2962,12.04
46,229.5,416,1.69,3378,13.73
46,226.5,429,1.74,3807,15.48
46,223.5,407,1.65,4214,17.13
46,220.5,472,1.92,4686,19.05
46,217.5,444,1.81,5130,20.86
46,214.5,420,1.71,5550,22.56
46,211.5,465,1.89,6015,24.45
46,208.5,440,1.79,6455,26.24
46,205.5,471,1.91,6926,28.16
46,202.5,460,1.87,7386,30.03
46,199.5,420,1.71,7806,31.73
46,196.5,427,1.74,8233,33.47
46,193.5,470,1.91,8703,35.38
46,190.5,427,1.74,9130,37.12
46,187.5,446,1.81,9576,38.93
46,184.5,450,1.83,10026,40.76
46,181.5,466,1.89,10492,42.65
46,178.5,450,1.83,10942,44.48
46,175.5,475,1.93,11417,46.41
46,172.5,451,1.83,11868,48.25
46,169.5,498,2.02,12366,50.27
46,166.5,492,2,12858,52.27
46,163.5,483,1.96,13341,54.24
46,160.5,498,2.02,13839,56.26
46,157.5,530,2.15,14369,58.42
46,154.5,498,2.02,14867,60.44
46,151.5,500,2.03,15367,62.47
46,148.5,482,1.96,15849,64.43
46,145.5,497,2.02,16346,66.45
46,142.5,488,1.98,16834,68.44
46,139.5,481,1.96,17315,70.39
46,136.5,445,1.81,17760,72.2
46,133.5,450,1.83,18210,74.03
46,130.5,468,1.9,18678,75.93
46,127.5,451,1.83,19129,77.77
46,124.5,434,1.76,19563,79.53
46,121.5,395,1.61,19958,81.14
46,118.5,372,1.51,20330,82.65
46,115.5,342,1.39,20672,84.04
46,112.5,341,1.39,21013,85.43
46,109.5,293,1.19,21306,86.62
46,106.5,296,1.2,21602,87.82
46,103.5,262,1.07,21864,88.89
46,100.5,222,0.9,22086,89.79
46,97.5,212,0.86,22298,90.65
46,94.5,176,0.72,22474,91.37
46,91.5,175,0.71,22649,92.08
46,88.5,138,0.56,22787,92.64
46,85.5,135,0.55,22922,93.19
46,82.5,146,0.59,23068,93.78
46,79.5,105,0.43,23173,94.21
46,76.5,85,0.35,23258,94.55
46,73.5,85,0.35,23343,94.9
46,70.5,58,0.24,23401,95.13
46,67.5,47,0.19,23448,95.32
46,64.5,42,0.17,23490,95.5
46,61.5,35,0.14,23525,95.64
46,58.5,24,0.1,23549,95.74
46,55.5,19,0.08,23568,95.81
46,52.5,11,0.04,23579,95.86
46,49.5,13,0.05,23592,95.91
46,46.5,8,0.03,23600,95.94
46,43.5,7,0.03,23607,95.97
46,40.5,5,0.02,23612,95.99
46,37.5,5,0.02,23617,96.01
46,34.5,5,0.02,23622,96.03
46,31.5,5,0.02,23627,96.05
46,28.5,3,0.01,23630,96.06
46,25.5,1,0,23631,96.07
46,22.5,0,0,23631,96.07
46,19.5,1,0,23632,96.07
46,16.5,1,0,23633,96.08
46,13.5,1,0,23634,96.08
46,10.5,0,0,23634,96.08
46,7.5,0,0,23634,96.08
46,4.5,0,0,23634,96.08
46,1.5,964,3.92,24598,100
47,398,0,0,0,0
47,394,0,0,0,0
47,390,0,0,0,0
47,386,0,0,0,0
47,382,0,0,0,0
47,378,1,0,1,0
47,374,2,0.01,3,0.01
47,370,6,0.03,9,0.04
47,366,5,0.02,14,0.06
47,362,16,0.07,30,0.14
47,358,27,0.12,57,0.26
47,354,53,0.25,110,0.51
47,350,71,0.33,181,0.84
47,346,100,0.46,281,1.3
47,342,124,0.57,405,1.87
47,338,166,0.77,571,2.64
47,334,209,0.97,780,3.61
47,330,252,1.17,1032,4.77
47,326,266,1.23,1298,6
47,322,304,1.41,1602,7.41
47,318,377,1.74,1979,9.15
47,314,361,1.67,2340,10.82
47,310,375,1.73,2715,12.56
47,306,390,1.8,3105,14.36
47,302,397,1.84,3502,16.2
47,298,400,1.85,3902,18.05
47,294,426,1.97,4328,20.02
47,290,404,1.87,4732,21.89
47,286,447,2.07,5179,23.95
47,282,404,1.87,5583,25.82
47,278,421,1.95,6004,27.77
47,274,427,1.97,6431,29.74
47,270,448,2.07,6879,31.81
47,266,448,2.07,7327,33.89
47,262,471,2.18,7798,36.07
47,258,437,2.02,8235,38.09
47,254,424,1.96,8659,40.05
47,250,458,2.12,9117,42.17
47,246,451,2.09,9568,44.25
47,242,429,1.98,9997,46.24
47,238,485,2.24,10482,48.48
47,234,455,2.1,10937,50.58
47,230,484,2.24,11421,52.82
47,226,466,2.16,11887,54.98
47,222,453,2.1,12340,57.07
47,218,461,2.13,12801,59.2
47,214,447,2.07,13248,61.27
47,210,402,1.86,13650,63.13
47,206,457,2.11,14107,65.24
47,202,488,2.26,14595,67.5
47,198,425,1.97,15020,69.47
47,194,430,1.99,15450,71.45
47,190,410,1.9,15860,73.35
47,186,392,1.81,16252,75.16
47,182,410,1.9,16662,77.06
47,178,393,1.82,17055,78.88
47,174,346,1.6,17401,80.48
47,170,346,1.6,17747,82.08
47,166,350,1.62,18097,83.7
47,162,277,1.28,18374,84.98
47,158,276,1.28,18650,86.25
47,154,264,1.22,18914,87.48
47,150,242,1.12,19156,88.59
47,146,195,0.9,19351,89.5
47,142,204,0.94,19555,90.44
47,138,181,0.84,19736,91.28
47,134,142,0.66,19878,91.93
47,130,107,0.49,19985,92.43
47,126,130,0.6,20115,93.03
47,122,82,0.38,20197,93.41
47,118,92,0.43,20289,93.83
47,114,66,0.31,20355,94.14
47,110,74,0.34,20429,94.48
47,106,58,0.27,20487,94.75
47,102,61,0.28,20548,95.03
47,98,31,0.14,20579,95.18
47,94,34,0.16,20613,95.33
47,90,30,0.14,20643,95.47
47,86,30,0.14,20673,95.61
47,82,29,0.13,20702,95.75
47,78,11,0.05,20713,95.8
47,74,20,0.09,20733,95.89
47,70,11,0.05,20744,95.94
47,66,5,0.02,20749,95.96
47,62,13,0.06,20762,96.02
47,58,9,0.04,20771,96.06
47,54,6,0.03,20777,96.09
47,50,3,0.01,20780,96.11
47,46,7,0.03,20787,96.14
47,42,5,0.02,20792,96.16
47,38,4,0.02,20796,96.18
47,34,2,0.01,20798,96.19
47,30,3,0.01,20801,96.2
47,26,1,0,20802,96.21
47,22,0,0,20802,96.21
47,18,0,0,20802,96.21
47,14,2,0.01,20804,96.22
47,10,0,0,20804,96.22
47,6,0,0,20804,96.22
47,2,818,3.78,21622,100
48,298.5,0,0,0,0
48,295.5,0,0,0,0
48,292.5,0,0,0,0
48,289.5,0,0,0,0
48,286.5,0,0,0,0
48,283.5,0,0,0,0
48,280.5,1,0,1,0
48,277.5,1,0,2,0.01
48,274.5,5,0.02,7,0.03
48,271.5,10,0.04,17,0.07
48,268.5,16,0.06,33,0.13
48,265.5,30,0.12,63,0.24
48,262.5,54,0.21,117,0.45
48,259.5,76,0.3,193,0.75
48,256.5,123,0.48,316,1.23
48,253.5,133,0.52,449,1.74
48,250.5,209,0.81,658,2.56
48,247.5,239,0.93,897,3.48
48,244.5,249,0.97,1146,4.45
48,241.5,333,1.29,1479,5.75
48,238.5,332,1.29,1811,7.03
48,235.5,419,1.63,2230,8.66
48,232.5,441,1.71,2671,10.38
48,229.5,482,1.87,3153,12.25
48,226.5,451,1.75,3604,14
48,223.5,484,1.88,4088,15.88
48,220.5,465,1.81,4553,17.69
48,217.5,499,1.94,5052,19.62
48,214.5,519,2.02,5571,21.64
48,211.5,482,1.87,6053,23.51
48,208.5,514,2,6567,25.51
48,205.5,501,1.95,7068,27.46
48,202.5,527,2.05,7595,29.5
48,199.5,487,1.89,8082,31.39
48,196.5,497,1.93,8579,33.33
48,193.5,487,1.89,9066,35.22
48,190.5,505,1.96,9571,37.18
48,187.5,516,2,10087,39.18
48,184.5,514,2,10601,41.18
48,181.5,457,1.78,11058,42.96
48,178.5,548,2.13,11606,45.08
48,175.5,506,1.97,12112,47.05
48,172.5,541,2.1,12653,49.15
48,169.5,559,2.17,13212,51.32
48,166.5,513,1.99,13725,53.32
48,163.5,537,2.09,14262,55.4
48,160.5,592,2.3,14854,57.7
48,157.5,528,2.05,15382,59.75
48,154.5,551,2.14,15933,61.89
48,151.5,596,2.32,16529,64.21
48,148.5,551,2.14,17080,66.35
48,145.5,536,2.08,17616,68.43
48,142.5,532,2.07,18148,70.5
48,139.5,577,2.24,18725,72.74
48,136.5,502,1.95,19227,74.69
48,133.5,477,1.85,19704,76.54
48,130.5,445,1.73,20149,78.27
48,127.5,436,1.69,20585,79.96
48,124.5,437,1.7,21022,81.66
48,121.5,371,1.44,21393,83.1
48,118.5,364,1.41,21757,84.52
48,115.5,342,1.33,22099,85.84
48,112.5,288,1.12,22387,86.96
48,109.5,302,1.17,22689,88.14
48,106.5,252,0.98,22941,89.12
48,103.5,228,0.89,23169,90
48,100.5,190,0.74,23359,90.74
48,97.5,191,0.74,23550,91.48
48,94.5,165,0.64,23715,92.12
48,91.5,139,0.54,23854,92.66
48,88.5,142,0.55,23996,93.21
48,85.5,116,0.45,24112,93.66
48,82.5,101,0.39,24213,94.06
48,79.5,108,0.42,24321,94.48
48,76.5,67,0.26,24388,94.74
48,73.5,57,0.22,24445,94.96
48,70.5,53,0.21,24498,95.16
48,67.5,39,0.15,24537,95.32
48,64.5,45,0.17,24582,95.49
48,61.5,24,0.09,24606,95.58
48,58.5,23,0.09,24629,95.67
48,55.5,20,0.08,24649,95.75
48,52.5,9,0.03,24658,95.79
48,49.5,10,0.04,24668,95.82
48,46.5,7,0.03,24675,95.85
48,43.5,7,0.03,24682,95.88
48,40.5,5,0.02,24687,95.9
48,37.5,5,0.02,24692,95.92
48,34.5,4,0.02,24696,95.93
48,31.5,3,0.01,24699,95.94
48,28.5,2,0.01,24701,95.95
48,25.5,0,0,24701,95.95
48,22.5,1,0,24702,95.96
48,19.5,1,0,24703,95.96
48,16.5,1,0,24704,95.96
48,13.5,2,0.01,24706,95.97
48,10.5,0,0,24706,95.97
48,7.5,2,0.01,24708,95.98
48,4.5,0,0,24708,95.98
48,1.5,1035,4.02,25743,100
50,398,0,0,0,0
50,394,0,0,0,0
50,390,0,0,0,0
50,386,0,0,0,0
50,382,0,0,0,0
50,378,0,0,0,0
50,374,1,0,1,0
50,370,6,0.03,7,0.03
50,366,5,0.02,12,0.05
50,362,9,0.04,21,0.09
50,358,16,0.07,37,0.16
50,354,29,0.13,66,0.29
50,350,67,0.3,133,0.59
50,346,68,0.3,201,0.89
50,342,109,0.48,310,1.38
50,338,137,0.61,447,1.99
50,334,196,0.87,643,2.86
50,330,221,0.98,864,3.84
50,326,246,1.09,1110,4.93
50,322,298,1.32,1408,6.25
50,318,355,1.58,1763,7.83
50,314,421,1.87,2184,9.7
50,310,417,1.85,2601,11.55
50,306,419,1.86,3020,13.42
50,302,425,1.89,3445,15.3
50,298,432,1.92,3877,17.22
50,294,473,2.1,4350,19.32
50,290,454,2.02,4804,21.34
50,286,450,2,5254,23.34
50,282,487,2.16,5741,25.5
50,278,458,2.03,6199,27.54
50,274,504,2.24,6703,29.78
50,270,520,2.31,7223,32.09
50,266,504,2.24,7727,34.33
50,262,464,2.06,8191,36.39
50,258,473,2.1,8664,38.49
50,254,461,2.05,9125,40.54
50,250,492,2.19,9617,42.72
50,246,476,2.11,10093,44.84
50,242,508,2.26,10601,47.09
50,238,510,2.27,11111,49.36
50,234,508,2.26,11619,51.62
50,230,478,2.12,12097,53.74
50,226,549,2.44,12646,56.18
50,222,495,2.2,13141,58.38
50,218,522,2.32,13663,60.7
50,214,459,2.04,14122,62.74
50,210,509,2.26,14631,65
50,206,501,2.23,15132,67.22
50,202,478,2.12,15610,69.35
50,198,467,2.07,16077,71.42
50,194,478,2.12,16555,73.55
50,190,434,1.93,16989,75.47
50,186,389,1.73,17378,77.2
50,182,384,1.71,17762,78.91
50,178,386,1.71,18148,80.62
50,174,359,1.59,18507,82.22
50,170,316,1.4,18823,83.62
50,166,302,1.34,19125,84.96
50,162,293,1.3,19418,86.26
50,158,276,1.23,19694,87.49
50,154,245,1.09,19939,88.58
50,150,220,0.98,20159,89.56
50,146,199,0.88,20358,90.44
50,142,165,0.73,20523,91.17
50,138,148,0.66,20671,91.83
50,134,147,0.65,20818,92.48
50,130,96,0.43,20914,92.91
50,126,99,0.44,21013,93.35
50,122,94,0.42,21107,93.77
50,118,74,0.33,21181,94.1
50,114,81,0.36,21262,94.46
50,110,63,0.28,21325,94.74
50,106,44,0.2,21369,94.93
50,102,44,0.2,21413,95.13
50,98,36,0.16,21449,95.29
50,94,21,0.09,21470,95.38
50,90,34,0.15,21504,95.53
50,86,23,0.1,21527,95.63
50,82,29,0.13,21556,95.76
50,78,15,0.07,21571,95.83
50,74,11,0.05,21582,95.88
50,70,14,0.06,21596,95.94
50,66,5,0.02,21601,95.96
50,62,9,0.04,21610,96
50,58,9,0.04,21619,96.04
50,54,5,0.02,21624,96.06
50,50,3,0.01,21627,96.08
50,46,7,0.03,21634,96.11
50,42,5,0.02,21639,96.13
50,38,3,0.01,21642,96.14
50,34,2,0.01,21644,96.15
50,30,2,0.01,21646,96.16
50,26,0,0,21646,96.16
50,22,1,0,21647,96.17
50,18,0,0,21647,96.17
50,14,2,0.01,21649,96.18
50,10,1,0,21650,96.18
50,6,1,0,21651,96.18
50,2,859,3.82,22510,100
51,398,0,0,0,0
51,394,0,0,0,0
51,390,0,0,0,0
51,386,0,0,0,0
51,382,0,0,0,0
51,378,0,0,0,0
51,374,0,0,0,0
51,370,2,0.01,2,0.01
51,366,2,0.01,4,0.02
51,362,10,0.04,14,0.06
51,358,16,0.07,30,0.12
51,354,26,0.11,56,0.23
51,350,37,0.15,93,0.38
51,346,59,0.24,152,0.62
51,342,97,0.4,249,1.02
51,338,130,0.53,379,1.55
51,334,156,0.64,535,2.19
51,330,208,0.85,743,3.04
51,326,223,0.91,966,3.95
51,322,288,1.18,1254,5.12
51,318,325,1.33,1579,6.45
51,314,338,1.38,1917,7.83
51,310,365,1.49,2282,9.32
51,306,429,1.75,2711,11.08
51,302,405,1.65,3116,12.73
51,298,449,1.83,3565,14.57
51,294,458,1.87,4023,16.44
51,290,457,1.87,4480,18.31
51,286,463,1.89,4943,20.2
51,282,468,1.91,5411,22.11
51,278,492,2.01,5903,24.12
51,274,534,2.18,6437,26.3
51,270,480,1.96,6917,28.26
51,266,493,2.01,7410,30.28
51,262,460,1.88,7870,32.16
51,258,520,2.12,8390,34.28
51,254,493,2.01,8883,36.3
51,250,517,2.11,9400,38.41
51,246,498,2.03,9898,40.44
51,242,527,2.15,10425,42.6
51,238,531,2.17,10956,44.77
51,234,515,2.1,11471,46.87
51,230,502,2.05,11973,48.92
51,226,518,2.12,12491,51.04
51,222,543,2.22,13034,53.26
51,218,544,2.22,13578,55.48
51,214,495,2.02,14073,57.5
51,210,539,2.2,14612,59.71
51,206,530,2.17,15142,61.87
51,202,539,2.2,15681,64.07
51,198,518,2.12,16199,66.19
51,194,479,1.96,16678,68.15
51,190,491,2.01,17169,70.15
51,186,457,1.87,17626,72.02
51,182,461,1.88,18087,73.91
51,178,451,1.84,18538,75.75
51,174,468,1.91,19006,77.66
51,170,446,1.82,19452,79.48
51,166,403,1.65,19855,81.13
51,162,375,1.53,20230,82.66
51,158,368,1.5,20598,84.17
51,154,297,1.21,20895,85.38
51,150,336,1.37,21231,86.75
51,146,260,1.06,21491,87.82
51,142,248,1.01,21739,88.83
51,138,202,0.83,21941,89.65
51,134,203,0.83,22144,90.48
51,130,184,0.75,22328,91.24
51,126,170,0.69,22498,91.93
51,122,140,0.57,22638,92.5
51,118,129,0.53,22767,93.03
51,114,100,0.41,22867,93.44
51,110,119,0.49,22986,93.92
51,106,99,0.4,23085,94.33
51,102,71,0.29,23156,94.62
51,98,57,0.23,23213,94.85
51,94,57,0.23,23270,95.08
51,90,49,0.2,23319,95.28
51,86,40,0.16,23359,95.45
51,82,35,0.14,23394,95.59
51,78,23,0.09,23417,95.69
51,74,21,0.09,23438,95.77
51,70,15,0.06,23453,95.83
51,66,10,0.04,23463,95.87
51,62,16,0.07,23479,95.94
51,58,8,0.03,23487,95.97
51,54,7,0.03,23494,96
51,50,5,0.02,23499,96.02
51,46,5,0.02,23504,96.04
51,42,5,0.02,23509,96.06
51,38,4,0.02,23513,96.08
51,34,2,0.01,23515,96.09
51,30,6,0.02,23521,96.11
51,26,0,0,23521,96.11
51,22,1,0,23522,96.11
51,18,1,0,23523,96.12
51,14,2,0.01,23525,96.13
51,10,0,0,23525,96.13
51,6,1,0,23526,96.13
51,2,947,3.87,24473,100
54,497.5,0,0,0,0
54,492.5,0,0,0,0
54,487.5,0,0,0,0
54,482.5,0,0,0,0
54,477.5,0,0,0,0
54,472.5,0,0,0,0
54,467.5,0,0,0,0
54,462.5,5,0.02,5,0.02
54,457.5,1,0,6,0.03
54,452.5,8,0.04,14,0.06
54,447.5,17,0.08,31,0.14
54,442.5,23,0.11,54,0.25
54,437.5,41,0.19,95,0.44
54,432.5,66,0.31,161,0.75
54,427.5,88,0.41,249,1.16
54,422.5,107,0.5,356,1.65
54,417.5,162,0.75,518,2.4
54,412.5,188,0.87,706,3.28
54,407.5,220,1.02,926,4.3
54,402.5,262,1.22,1188,5.51
54,397.5,309,1.43,1497,6.95
54,392.5,342,1.59,1839,8.54
54,387.5,386,1.79,2225,10.33
54,382.5,419,1.94,2644,12.27
54,377.5,356,1.65,3000,13.92
54,372.5,395,1.83,3395,15.76
54,367.5,441,2.05,3836,17.8
54,362.5,426,1.98,4262,19.78
54,357.5,430,2,4692,21.78
54,352.5,461,2.14,5153,23.92
54,347.5,418,1.94,5571,25.86
54,342.5,490,2.27,6061,28.13
54,337.5,475,2.2,6536,30.34
54,332.5,486,2.26,7022,32.59
54,327.5,492,2.28,7514,34.87
54,322.5,492,2.28,8006,37.16
54,317.5,475,2.2,8481,39.36
54,312.5,454,2.11,8935,41.47
54,307.5,483,2.24,9418,43.71
54,302.5,461,2.14,9879,45.85
54,297.5,501,2.33,10380,48.18
54,292.5,495,2.3,10875,50.47
54,287.5,506,2.35,11381,52.82
54,282.5,497,2.31,11878,55.13
54,277.5,485,2.25,12363,57.38
54,272.5,464,2.15,12827,59.53
54,267.5,459,2.13,13286,61.66
54,262.5,450,2.09,13736,63.75
54,257.5,504,2.34,14240,66.09
54,252.5,434,2.01,14674,68.11
54,247.5,441,2.05,15115,70.15
54,242.5,450,2.09,15565,72.24
54,237.5,397,1.84,15962,74.08
54,232.5,411,1.91,16373,75.99
54,227.5,412,1.91,16785,77.9
54,222.5,368,1.71,17153,79.61
54,217.5,339,1.57,17492,81.18
54,212.5,295,1.37,17787,82.55
54,207.5,306,1.42,18093,83.97
54,202.5,280,1.3,18373,85.27
54,197.5,252,1.17,18625,86.44
54,192.5,242,1.12,18867,87.57
54,187.5,204,0.95,19071,88.51
54,182.5,196,0.91,19267,89.42
54,177.5,203,0.94,19470,90.36
54,172.5,159,0.74,19629,91.1
54,167.5,135,0.63,19764,91.73
54,162.5,127,0.59,19891,92.32
54,157.5,123,0.57,20014,92.89
54,152.5,95,0.44,20109,93.33
54,147.5,86,0.4,20195,93.73
54,142.5,91,0.42,20286,94.15
54,137.5,76,0.35,20362,94.5
54,132.5,67,0.31,20429,94.82
54,127.5,50,0.23,20479,95.05
54,122.5,37,0.17,20516,95.22
54,117.5,27,0.13,20543,95.34
54,112.5,26,0.12,20569,95.47
54,107.5,25,0.12,20594,95.58
54,102.5,16,0.07,20610,95.66
54,97.5,7,0.03,20617,95.69
54,92.5,15,0.07,20632,95.76
54,87.5,16,0.07,20648,95.83
54,82.5,19,0.09,20667,95.92
54,77.5,11,0.05,20678,95.97
54,72.5,12,0.06,20690,96.03
54,67.5,7,0.03,20697,96.06
54,62.5,11,0.05,20708,96.11
54,57.5,8,0.04,20716,96.15
54,52.5,4,0.02,20720,96.17
54,47.5,5,0.02,20725,96.19
54,42.5,5,0.02,20730,96.21
54,37.5,4,0.02,20734,96.23
54,32.5,4,0.02,20738,96.25
54,27.5,0,0,20738,96.25
54,22.5,1,0,20739,96.25
54,17.5,1,0,20740,96.26
54,12.5,1,0,20741,96.26
54,7.5,1,0,20742,96.27
54,2.5,804,3.73,21546,100
55,298.5,0,0,0,0
55,295.5,0,0,0,0
55,292.5,0,0,0,0
55,289.5,1,0,1,0
55,286.5,5,0.01,6,0.02
55,283.5,8,0.02,14,0.04
55,280.5,13,0.04,27,0.08
55,277.5,30,0.08,57,0.16
55,274.5,65,0.18,122,0.34
55,271.5,117,0.33,239,0.67
55,268.5,156,0.44,395,1.11
55,265.5,190,0.54,585,1.65
55,262.5,259,0.73,844,2.38
55,259.5,316,0.89,1160,3.27
55,256.5,359,1.01,1519,4.28
55,253.5,423,1.19,1942,5.47
55,250.5,456,1.29,2398,6.76
55,247.5,495,1.4,2893,8.15
55,244.5,552,1.56,3445,9.71
55,241.5,567,1.6,4012,11.31
55,238.5,606,1.71,4618,13.02
55,235.5,595,1.68,5213,14.69
55,232.5,627,1.77,5840,16.46
55,229.5,608,1.71,6448,18.17
55,226.5,573,1.62,7021,19.79
55,223.5,658,1.85,7679,21.64
55,220.5,633,1.78,8312,23.43
55,217.5,635,1.79,8947,25.22
55,214.5,635,1.79,9582,27.01
55,211.5,652,1.84,10234,28.85
55,208.5,556,1.57,10790,30.41
55,205.5,600,1.69,11390,32.1
55,202.5,589,1.66,11979,33.76
55,199.5,614,1.73,12593,35.5
55,196.5,616,1.74,13209,37.23
55,193.5,584,1.65,13793,38.88
55,190.5,538,1.52,14331,40.39
55,187.5,537,1.51,14868,41.91
55,184.5,537,1.51,15405,43.42
55,181.5,556,1.57,15961,44.99
55,178.5,542,1.53,16503,46.52
55,175.5,526,1.48,17029,48
55,172.5,601,1.69,17630,49.69
55,169.5,606,1.71,18236,51.4
55,166.5,605,1.71,18841,53.11
55,163.5,574,1.62,19415,54.72
55,160.5,545,1.54,19960,56.26
55,157.5,592,1.67,20552,57.93
55,154.5,604,1.7,21156,59.63
55,151.5,619,1.74,21775,61.38
55,148.5,576,1.62,22351,63
55,145.5,577,1.63,22928,64.63
55,142.5,573,1.62,23501,66.24
55,139.5,540,1.52,24041,67.76
55,136.5,575,1.62,24616,69.38
55,133.5,543,1.53,25159,70.91
55,130.5,549,1.55,25708,72.46
55,127.5,557,1.57,26265,74.03
55,124.5,563,1.59,26828,75.62
55,121.5,562,1.58,27390,77.2
55,118.5,516,1.45,27906,78.66
55,115.5,537,1.51,28443,80.17
55,112.5,465,1.31,28908,81.48
55,109.5,449,1.27,29357,82.75
55,106.5,450,1.27,29807,84.02
55,103.5,449,1.27,30256,85.28
55,100.5,388,1.09,30644,86.37
55,97.5,383,1.08,31027,87.45
55,94.5,361,1.02,31388,88.47
55,91.5,371,1.05,31759,89.52
55,88.5,330,0.93,32089,90.45
55,85.5,283,0.8,32372,91.25
55,82.5,257,0.72,32629,91.97
55,79.5,242,0.68,32871,92.65
55,76.5,232,0.65,33103,93.31
55,73.5,198,0.56,33301,93.86
55,70.5,162,0.46,33463,94.32
55,67.5,142,0.4,33605,94.72
55,64.5,105,0.3,33710,95.02
55,61.5,99,0.28,33809,95.3
55,58.5,78,0.22,33887,95.52
55,55.5,68,0.19,33955,95.71
55,52.5,54,0.15,34009,95.86
55,49.5,37,0.1,34046,95.96
55,46.5,28,0.08,34074,96.04
55,43.5,18,0.05,34092,96.09
55,40.5,14,0.04,34106,96.13
55,37.5,4,0.01,34110,96.14
55,34.5,7,0.02,34117,96.16
55,31.5,4,0.01,34121,96.18
55,28.5,2,0.01,34123,96.18
55,25.5,0,0,34123,96.18
55,22.5,3,0.01,34126,96.19
55,19.5,4,0.01,34130,96.2
55,16.5,8,0.02,34138,96.22
55,13.5,5,0.01,34143,96.24
55,10.5,2,0.01,34145,96.24
55,7.5,5,0.01,34150,96.26
55,4.5,0,0,34150,96.26
55,1.5,1328,3.74,35478,100
57,398,0,0,0,0
57,394,0,0,0,0
57,390,0,0,0,0
57,386,0,0,0,0
57,382,1,0,1,0
57,378,1,0,2,0.01
57,374,2,0.01,4,0.02
57,370,13,0.06,17,0.08
57,366,27,0.12,44,0.2
57,362,45,0.2,89,0.4
57,358,45,0.2,134,0.6
57,354,68,0.31,202,0.91
57,350,102,0.46,304,1.36
57,346,138,0.62,442,1.98
57,342,163,0.73,605,2.71
57,338,200,0.9,805,3.61
57,334,239,1.07,1044,4.68
57,330,262,1.18,1306,5.86
57,326,289,1.3,1595,7.16
57,322,330,1.48,1925,8.64
57,318,341,1.53,2266,10.17
57,314,310,1.39,2576,11.56
57,310,356,1.6,2932,13.15
57,306,362,1.62,3294,14.78
57,302,386,1.73,3680,16.51
57,298,395,1.77,4075,18.28
57,294,390,1.75,4465,20.03
57,290,349,1.57,4814,21.6
57,286,365,1.64,5179,23.23
57,282,382,1.71,5561,24.95
57,278,360,1.61,5921,26.56
57,274,369,1.66,6290,28.22
57,270,419,1.88,6709,30.1
57,266,371,1.66,7080,31.76
57,262,400,1.79,7480,33.55
57,258,400,1.79,7880,35.35
57,254,397,1.78,8277,37.13
57,250,344,1.54,8621,38.67
57,246,362,1.62,8983,40.3
57,242,378,1.7,9361,41.99
57,238,409,1.83,9770,43.83
57,234,394,1.77,10164,45.59
57,230,440,1.97,10604,47.57
57,226,413,1.85,11017,49.42
57,222,404,1.81,11421,51.23
57,218,408,1.83,11829,53.06
57,214,429,1.92,12258,54.99
57,210,435,1.95,12693,56.94
57,206,443,1.99,13136,58.93
57,202,448,2.01,13584,60.94
57,198,413,1.85,13997,62.79
57,194,417,1.87,14414,64.66
57,190,431,1.93,14845,66.59
57,186,466,2.09,15311,68.68
57,182,422,1.89,15733,70.58
57,178,425,1.91,16158,72.48
57,174,427,1.92,16585,74.4
57,170,412,1.85,16997,76.25
57,166,432,1.94,17429,78.18
57,162,363,1.63,17792,79.81
57,158,365,1.64,18157,81.45
57,154,323,1.45,18480,82.9
57,150,344,1.54,18824,84.44
57,146,306,1.37,19130,85.82
57,142,262,1.18,19392,86.99
57,138,251,1.13,19643,88.12
57,134,246,1.1,19889,89.22
57,130,214,0.96,20103,90.18
57,126,207,0.93,20310,91.11
57,122,162,0.73,20472,91.84
57,118,172,0.77,20644,92.61
57,114,132,0.59,20776,93.2
57,110,101,0.45,20877,93.65
57,106,97,0.44,20974,94.09
57,102,85,0.38,21059,94.47
57,98,64,0.29,21123,94.76
57,94,55,0.25,21178,95
57,90,72,0.32,21250,95.33
57,86,41,0.18,21291,95.51
57,82,43,0.19,21334,95.7
57,78,28,0.13,21362,95.83
57,74,29,0.13,21391,95.96
57,70,10,0.04,21401,96
57,66,15,0.07,21416,96.07
57,62,6,0.03,21422,96.1
57,58,8,0.04,21430,96.13
57,54,10,0.04,21440,96.18
57,50,6,0.03,21446,96.2
57,46,3,0.01,21449,96.22
57,42,4,0.02,21453,96.24
57,38,1,0,21454,96.24
57,34,1,0,21455,96.25
57,30,3,0.01,21458,96.26
57,26,0,0,21458,96.26
57,22,3,0.01,21461,96.27
57,18,3,0.01,21464,96.29
57,14,6,0.03,21470,96.31
57,10,3,0.01,21473,96.33
57,6,3,0.01,21476,96.34
57,2,816,3.66,22292,100
58,497.5,0,0,0,0
58,492.5,0,0,0,0
58,487.5,0,0,0,0
58,482.5,0,0,0,0
58,477.5,0,0,0,0
58,472.5,0,0,0,0
58,467.5,2,0.03,2,0.03
58,462.5,3,0.04,5,0.07
58,457.5,5,0.07,10,0.14
58,452.5,9,0.13,19,0.27
58,447.5,13,0.18,32,0.45
58,442.5,20,0.28,52,0.73
58,437.5,38,0.53,90,1.26
58,432.5,33,0.46,123,1.73
58,427.5,65,0.91,188,2.64
58,422.5,49,0.69,237,3.33
58,417.5,75,1.05,312,4.38
58,412.5,81,1.14,393,5.51
58,407.5,97,1.36,490,6.88
58,402.5,92,1.29,582,8.17
58,397.5,102,1.43,684,9.6
58,392.5,92,1.29,776,10.89
58,387.5,96,1.35,872,12.24
58,382.5,112,1.57,984,13.81
58,377.5,130,1.82,1114,15.63
58,372.5,133,1.87,1247,17.5
58,367.5,138,1.94,1385,19.43
58,362.5,130,1.82,1515,21.26
58,357.5,130,1.82,1645,23.08
58,352.5,127,1.78,1772,24.86
58,347.5,136,1.91,1908,26.77
58,342.5,176,2.47,2084,29.24
58,337.5,144,2.02,2228,31.26
58,332.5,139,1.95,2367,33.21
58,327.5,166,2.33,2533,35.54
58,322.5,145,2.03,2678,37.58
58,317.5,143,2.01,2821,39.58
58,312.5,145,2.03,2966,41.62
58,307.5,139,1.95,3105,43.57
58,302.5,156,2.19,3261,45.76
58,297.5,143,2.01,3404,47.76
58,292.5,155,2.17,3559,49.94
58,287.5,125,1.75,3684,51.69
58,282.5,135,1.89,3819,53.58
58,277.5,120,1.68,3939,55.27
58,272.5,143,2.01,4082,57.28
58,267.5,120,1.68,4202,58.96
58,262.5,100,1.4,4302,60.36
58,257.5,116,1.63,4418,61.99
58,252.5,127,1.78,4545,63.77
58,247.5,132,1.85,4677,65.62
58,242.5,96,1.35,4773,66.97
58,237.5,105,1.47,4878,68.44
58,232.5,111,1.56,4989,70
58,227.5,111,1.56,5100,71.56
58,222.5,110,1.54,5210,73.1
58,217.5,105,1.47,5315,74.58
58,212.5,97,1.36,5412,75.94
58,207.5,99,1.39,5511,77.33
58,202.5,90,1.26,5601,78.59
58,197.5,65,0.91,5666,79.5
58,192.5,84,1.18,5750,80.68
58,187.5,106,1.49,5856,82.17
58,182.5,96,1.35,5952,83.51
58,177.5,72,1.01,6024,84.52
58,172.5,77,1.08,6101,85.6
58,167.5,70,0.98,6171,86.59
58,162.5,64,0.9,6235,87.48
58,157.5,72,1.01,6307,88.49
58,152.5,59,0.83,6366,89.32
58,147.5,53,0.74,6419,90.07
58,142.5,57,0.8,6476,90.87
58,137.5,54,0.76,6530,91.62
58,132.5,43,0.6,6573,92.23
58,127.5,43,0.6,6616,92.83
58,122.5,44,0.62,6660,93.45
58,117.5,31,0.43,6691,93.88
58,112.5,29,0.41,6720,94.29
58,107.5,22,0.31,6742,94.6
58,102.5,21,0.29,6763,94.89
58,97.5,28,0.39,6791,95.29
58,92.5,8,0.11,6799,95.4
58,87.5,18,0.25,6817,95.65
58,82.5,14,0.2,6831,95.85
58,77.5,11,0.15,6842,96
58,72.5,6,0.08,6848,96.09
58,67.5,3,0.04,6851,96.13
58,62.5,3,0.04,6854,96.17
58,57.5,4,0.06,6858,96.23
58,52.5,0,0,6858,96.23
58,47.5,1,0.01,6859,96.24
58,42.5,1,0.01,6860,96.25
58,37.5,1,0.01,6861,96.27
58,32.5,1,0.01,6862,96.28
58,27.5,3,0.04,6865,96.32
58,22.5,2,0.03,6867,96.35
58,17.5,3,0.04,6870,96.39
58,12.5,0,0,6870,96.39
58,7.5,2,0.03,6872,96.42
58,2.5,255,3.58,7127,100
59,398,0,0,0,0
59,394,0,0,0,0
59,390,0,0,0,0
59,386,0,0,0,0
59,382,0,0,0,0
59,378,2,0.01,2,0.01
59,374,2,0.01,4,0.02
59,370,4,0.02,8,0.03
59,366,29,0.12,37,0.16
59,362,19,0.08,56,0.24
59,358,42,0.18,98,0.41
59,354,50,0.21,148,0.62
59,350,108,0.45,256,1.07
59,346,122,0.51,378,1.59
59,342,131,0.55,509,2.14
59,338,192,0.81,701,2.94
59,334,251,1.05,952,4
59,330,234,0.98,1186,4.98
59,326,245,1.03,1431,6.01
59,322,320,1.34,1751,7.35
59,318,299,1.26,2050,8.61
59,314,334,1.4,2384,10.01
59,310,362,1.52,2746,11.53
59,306,336,1.41,3082,12.94
59,302,375,1.57,3457,14.52
59,298,405,1.7,3862,16.22
59,294,387,1.63,4249,17.84
59,290,389,1.63,4638,19.48
59,286,390,1.64,5028,21.11
59,282,368,1.55,5396,22.66
59,278,408,1.71,5804,24.37
59,274,377,1.58,6181,25.96
59,270,361,1.52,6542,27.47
59,266,402,1.69,6944,29.16
59,262,383,1.61,7327,30.77
59,258,396,1.66,7723,32.43
59,254,409,1.72,8132,34.15
59,250,392,1.65,8524,35.79
59,246,415,1.74,8939,37.54
59,242,438,1.84,9377,39.38
59,238,381,1.6,9758,40.98
59,234,427,1.79,10185,42.77
59,230,399,1.68,10584,44.44
59,226,419,1.76,11003,46.2
59,222,384,1.61,11387,47.82
59,218,419,1.76,11806,49.58
59,214,418,1.76,12224,51.33
59,210,408,1.71,12632,53.04
59,206,464,1.95,13096,54.99
59,202,476,2,13572,56.99
59,198,444,1.86,14016,58.86
59,194,427,1.79,14443,60.65
59,190,458,1.92,14901,62.57
59,186,452,1.9,15353,64.47
59,182,461,1.94,15814,66.41
59,178,447,1.88,16261,68.28
59,174,438,1.84,16699,70.12
59,170,469,1.97,17168,72.09
59,166,473,1.99,17641,74.08
59,162,423,1.78,18064,75.85
59,158,402,1.69,18466,77.54
59,154,422,1.77,18888,79.31
59,150,389,1.63,19277,80.95
59,146,353,1.48,19630,82.43
59,142,341,1.43,19971,83.86
59,138,318,1.34,20289,85.2
59,134,338,1.42,20627,86.62
59,130,257,1.08,20884,87.7
59,126,245,1.03,21129,88.73
59,122,234,0.98,21363,89.71
59,118,207,0.87,21570,90.58
59,114,204,0.86,21774,91.43
59,110,176,0.74,21950,92.17
59,106,143,0.6,22093,92.77
59,102,138,0.58,22231,93.35
59,98,128,0.54,22359,93.89
59,94,119,0.5,22478,94.39
59,90,95,0.4,22573,94.79
59,86,85,0.36,22658,95.15
59,82,59,0.25,22717,95.39
59,78,54,0.23,22771,95.62
59,74,48,0.2,22819,95.82
59,70,28,0.12,22847,95.94
59,66,16,0.07,22863,96.01
59,62,14,0.06,22877,96.07
59,58,14,0.06,22891,96.12
59,54,10,0.04,22901,96.17
59,50,8,0.03,22909,96.2
59,46,6,0.03,22915,96.22
59,42,6,0.03,22921,96.25
59,38,3,0.01,22924,96.26
59,34,4,0.02,22928,96.28
59,30,4,0.02,22932,96.3
59,26,0,0,22932,96.3
59,22,3,0.01,22935,96.31
59,18,4,0.02,22939,96.33
59,14,5,0.02,22944,96.35
59,10,2,0.01,22946,96.36
59,6,3,0.01,22949,96.37
59,2,865,3.63,23814,100
60,398,0,0,0,0
60,394,0,0,0,0
60,390,0,0,0,0
60,386,0,0,0,0
60,382,0,0,0,0
60,378,0,0,0,0
60,374,2,0.01,2,0.01
60,370,3,0.01,5,0.02
60,366,6,0.02,11,0.04
60,362,14,0.06,25,0.1
60,358,35,0.14,60,0.24
60,354,44,0.18,104,0.42
60,350,71,0.29,175,0.71
60,346,85,0.34,260,1.05
60,342,131,0.53,391,1.58
60,338,164,0.66,555,2.24
60,334,180,0.73,735,2.96
60,330,217,0.87,952,3.84
60,326,264,1.06,1216,4.9
60,322,309,1.25,1525,6.15
60,318,337,1.36,1862,7.51
60,314,341,1.37,2203,8.88
60,310,361,1.46,2564,10.34
60,306,381,1.54,2945,11.87
60,302,420,1.69,3365,13.57
60,298,410,1.65,3775,15.22
60,294,405,1.63,4180,16.85
60,290,458,1.85,4638,18.7
60,286,437,1.76,5075,20.46
60,282,462,1.86,5537,22.33
60,278,389,1.57,5926,23.89
60,274,426,1.72,6352,25.61
60,270,402,1.62,6754,27.23
60,266,405,1.63,7159,28.87
60,262,416,1.68,7575,30.54
60,258,433,1.75,8008,32.29
60,254,457,1.84,8465,34.13
60,250,427,1.72,8892,35.85
60,246,418,1.69,9310,37.54
60,242,442,1.78,9752,39.32
60,238,464,1.87,10216,41.19
60,234,435,1.75,10651,42.95
60,230,452,1.82,11103,44.77
60,226,440,1.77,11543,46.54
60,222,445,1.79,11988,48.34
60,218,489,1.97,12477,50.31
60,214,457,1.84,12934,52.15
60,210,504,2.03,13438,54.18
60,206,475,1.92,13913,56.1
60,202,483,1.95,14396,58.05
60,198,466,1.88,14862,59.93
60,194,466,1.88,15328,61.8
60,190,481,1.94,15809,63.74
60,186,466,1.88,16275,65.62
60,182,498,2.01,16773,67.63
60,178,499,2.01,17272,69.64
60,174,535,2.16,17807,71.8
60,170,477,1.92,18284,73.72
60,166,503,2.03,18787,75.75
60,162,441,1.78,19228,77.53
60,158,431,1.74,19659,79.27
60,154,371,1.5,20030,80.76
60,150,385,1.55,20415,82.32
60,146,398,1.6,20813,83.92
60,142,332,1.34,21145,85.26
60,138,326,1.31,21471,86.57
60,134,284,1.15,21755,87.72
60,130,254,1.02,22009,88.74
60,126,245,0.99,22254,89.73
60,122,217,0.87,22471,90.61
60,118,196,0.79,22667,91.4
60,114,177,0.71,22844,92.11
60,110,164,0.66,23008,92.77
60,106,144,0.58,23152,93.35
60,102,127,0.51,23279,93.86
60,98,103,0.42,23382,94.28
60,94,84,0.34,23466,94.62
60,90,88,0.35,23554,94.97
60,86,66,0.27,23620,95.24
60,82,56,0.23,23676,95.46
60,78,48,0.19,23724,95.66
60,74,36,0.15,23760,95.8
60,70,22,0.09,23782,95.89
60,66,25,0.1,23807,95.99
60,62,8,0.03,23815,96.02
60,58,8,0.03,23823,96.06
60,54,7,0.03,23830,96.08
60,50,8,0.03,23838,96.12
60,46,7,0.03,23845,96.15
60,42,8,0.03,23853,96.18
60,38,1,0,23854,96.18
60,34,2,0.01,23856,96.19
60,30,3,0.01,23859,96.2
60,26,0,0,23859,96.2
60,22,5,0.02,23864,96.22
60,18,4,0.02,23868,96.24
60,14,5,0.02,23873,96.26
60,10,3,0.01,23876,96.27
60,6,4,0.02,23880,96.29
60,2,921,3.71,24801,100
62,497.5,0,0,0,0
62,492.5,0,0,0,0
62,487.5,0,0,0,0
62,482.5,0,0,0,0
62,477.5,0,0,0,0
62,472.5,0,0,0,0
62,467.5,2,0.01,2,0.01
62,462.5,2,0.01,4,0.02
62,457.5,6,0.03,10,0.05
62,452.5,12,0.05,22,0.1
62,447.5,25,0.11,47,0.21
62,442.5,43,0.2,90,0.41
62,437.5,66,0.3,156,0.71
62,432.5,77,0.35,233,1.06
62,427.5,100,0.45,333,1.51
62,422.5,120,0.55,453,2.06
62,417.5,190,0.86,643,2.92
62,412.5,193,0.88,836,3.8
62,407.5,236,1.07,1072,4.88
62,402.5,282,1.28,1354,6.16
62,397.5,333,1.51,1687,7.67
62,392.5,335,1.52,2022,9.2
62,387.5,366,1.66,2388,10.86
62,382.5,340,1.55,2728,12.41
62,377.5,386,1.76,3114,14.16
62,372.5,400,1.82,3514,15.98
62,367.5,405,1.84,3919,17.83
62,362.5,390,1.77,4309,19.6
62,357.5,410,1.86,4719,21.47
62,352.5,431,1.96,5150,23.43
62,347.5,397,1.81,5547,25.23
62,342.5,422,1.92,5969,27.15
62,337.5,389,1.77,6358,28.92
62,332.5,451,2.05,6809,30.97
62,327.5,419,1.91,7228,32.88
62,322.5,391,1.78,7619,34.66
62,317.5,402,1.83,8021,36.49
62,312.5,460,2.09,8481,38.58
62,307.5,397,1.81,8878,40.38
62,302.5,447,2.03,9325,42.42
62,297.5,424,1.93,9749,44.35
62,292.5,409,1.86,10158,46.21
62,287.5,451,2.05,10609,48.26
62,282.5,441,2.01,11050,50.26
62,277.5,453,2.06,11503,52.32
62,272.5,454,2.07,11957,54.39
62,267.5,467,2.12,12424,56.51
62,262.5,441,2.01,12865,58.52
62,257.5,442,2.01,13307,60.53
62,252.5,462,2.1,13769,62.63
62,247.5,430,1.96,14199,64.59
62,242.5,497,2.26,14696,66.85
62,237.5,454,2.07,15150,68.91
62,232.5,436,1.98,15586,70.9
62,227.5,455,2.07,16041,72.97
62,222.5,438,1.99,16479,74.96
62,217.5,419,1.91,16898,76.86
62,212.5,403,1.83,17301,78.7
62,207.5,374,1.7,17675,80.4
62,202.5,334,1.52,18009,81.92
62,197.5,356,1.62,18365,83.54
62,192.5,297,1.35,18662,84.89
62,187.5,275,1.25,18937,86.14
62,182.5,272,1.24,19209,87.38
62,177.5,235,1.07,19444,88.45
62,172.5,195,0.89,19639,89.33
62,167.5,213,0.97,19852,90.3
62,162.5,202,0.92,20054,91.22
62,157.5,160,0.73,20214,91.95
62,152.5,129,0.59,20343,92.54
62,147.5,158,0.72,20501,93.25
62,142.5,96,0.44,20597,93.69
62,137.5,92,0.42,20689,94.11
62,132.5,81,0.37,20770,94.48
62,127.5,67,0.3,20837,94.78
62,122.5,62,0.28,20899,95.06
62,117.5,55,0.25,20954,95.31
62,112.5,39,0.18,20993,95.49
62,107.5,22,0.1,21015,95.59
62,102.5,28,0.13,21043,95.72
62,97.5,21,0.1,21064,95.82
62,92.5,20,0.09,21084,95.91
62,87.5,25,0.11,21109,96.02
62,82.5,14,0.06,21123,96.08
62,77.5,9,0.04,21132,96.12
62,72.5,6,0.03,21138,96.15
62,67.5,8,0.04,21146,96.19
62,62.5,4,0.02,21150,96.21
62,57.5,6,0.03,21156,96.23
62,52.5,6,0.03,21162,96.26
62,47.5,4,0.02,21166,96.28
62,42.5,6,0.03,21172,96.31
62,37.5,0,0,21172,96.31
62,32.5,3,0.01,21175,96.32
62,27.5,1,0,21176,96.32
62,22.5,4,0.02,21180,96.34
62,17.5,5,0.02,21185,96.37
62,12.5,3,0.01,21188,96.38
62,7.5,6,0.03,21194,96.41
62,2.5,790,3.59,21984,100
63,497.5,0,0,0,0
63,492.5,0,0,0,0
63,487.5,0,0,0,0
63,482.5,0,0,0,0
63,477.5,0,0,0,0
63,472.5,0,0,0,0
63,467.5,0,0,0,0
63,462.5,1,0,1,0
63,457.5,7,0.03,8,0.03
63,452.5,10,0.04,18,0.08
63,447.5,16,0.07,34,0.14
63,442.5,35,0.15,69,0.29
63,437.5,44,0.19,113,0.48
63,432.5,75,0.32,188,0.79
63,427.5,105,0.44,293,1.24
63,422.5,129,0.54,422,1.78
63,417.5,173,0.73,595,2.51
63,412.5,209,0.88,804,3.39
63,407.5,209,0.88,1013,4.27
63,402.5,274,1.16,1287,5.43
63,397.5,286,1.21,1573,6.63
63,392.5,322,1.36,1895,7.99
63,387.5,331,1.4,2226,9.39
63,382.5,386,1.63,2612,11.02
63,377.5,383,1.62,2995,12.63
63,372.5,359,1.51,3354,14.15
63,367.5,417,1.76,3771,15.9
63,362.5,416,1.75,4187,17.66
63,357.5,440,1.86,4627,19.51
63,352.5,406,1.71,5033,21.23
63,347.5,443,1.87,5476,23.09
63,342.5,413,1.74,5889,24.84
63,337.5,426,1.8,6315,26.63
63,332.5,415,1.75,6730,28.38
63,327.5,439,1.85,7169,30.23
63,322.5,423,1.78,7592,32.02
63,317.5,442,1.86,8034,33.88
63,312.5,427,1.8,8461,35.68
63,307.5,453,1.91,8914,37.59
63,302.5,476,2.01,9390,39.6
63,297.5,459,1.94,9849,41.54
63,292.5,440,1.86,10289,43.39
63,287.5,445,1.88,10734,45.27
63,282.5,413,1.74,11147,47.01
63,277.5,453,1.91,11600,48.92
63,272.5,469,1.98,12069,50.9
63,267.5,476,2.01,12545,52.91
63,262.5,471,1.99,13016,54.89
63,257.5,498,2.1,13514,56.99
63,252.5,486,2.05,14000,59.04
63,247.5,496,2.09,14496,61.14
63,242.5,477,2.01,14973,63.15
63,237.5,450,1.9,15423,65.05
63,232.5,533,2.25,15956,67.29
63,227.5,484,2.04,16440,69.33
63,222.5,459,1.94,16899,71.27
63,217.5,455,1.92,17354,73.19
63,212.5,444,1.87,17798,75.06
63,207.5,428,1.81,18226,76.87
63,202.5,425,1.79,18651,78.66
63,197.5,407,1.72,19058,80.38
63,192.5,357,1.51,19415,81.88
63,187.5,359,1.51,19774,83.4
63,182.5,330,1.39,20104,84.79
63,177.5,320,1.35,20424,86.14
63,172.5,294,1.24,20718,87.38
63,167.5,246,1.04,20964,88.41
63,162.5,220,0.93,21184,89.34
63,157.5,207,0.87,21391,90.22
63,152.5,199,0.84,21590,91.05
63,147.5,180,0.76,21770,91.81
63,142.5,158,0.67,21928,92.48
63,137.5,139,0.59,22067,93.07
63,132.5,115,0.49,22182,93.55
63,127.5,110,0.46,22292,94.02
63,122.5,92,0.39,22384,94.4
63,117.5,105,0.44,22489,94.85
63,112.5,62,0.26,22551,95.11
63,107.5,61,0.26,22612,95.37
63,102.5,45,0.19,22657,95.55
63,97.5,30,0.13,22687,95.68
63,92.5,23,0.1,22710,95.78
63,87.5,32,0.13,22742,95.91
63,82.5,22,0.09,22764,96.01
63,77.5,13,0.05,22777,96.06
63,72.5,13,0.05,22790,96.12
63,67.5,12,0.05,22802,96.17
63,62.5,6,0.03,22808,96.19
63,57.5,7,0.03,22815,96.22
63,52.5,5,0.02,22820,96.24
63,47.5,5,0.02,22825,96.26
63,42.5,7,0.03,22832,96.29
63,37.5,1,0,22833,96.3
63,32.5,3,0.01,22836,96.31
63,27.5,1,0,22837,96.31
63,22.5,4,0.02,22841,96.33
63,17.5,5,0.02,22846,96.35
63,12.5,4,0.02,22850,96.37
63,7.5,5,0.02,22855,96.39
63,2.5,856,3.61,23711,100
64,298.5,0,0,0,0
64,295.5,0,0,0,0
64,292.5,0,0,0,0
64,289.5,0,0,0,0
64,286.5,0,0,0,0
64,283.5,2,0.01,2,0.01
64,280.5,2,0.01,4,0.02
64,277.5,1,0,5,0.02
64,274.5,5,0.02,10,0.04
64,271.5,10,0.04,20,0.08
64,268.5,16,0.07,36,0.15
64,265.5,24,0.1,60,0.25
64,262.5,40,0.16,100,0.41
64,259.5,52,0.21,152,0.62
64,256.5,76,0.31,228,0.93
64,253.5,115,0.47,343,1.41
64,250.5,165,0.68,508,2.08
64,247.5,176,0.72,684,2.8
64,244.5,194,0.8,878,3.6
64,241.5,252,1.03,1130,4.63
64,238.5,292,1.2,1422,5.83
64,235.5,330,1.35,1752,7.18
64,232.5,343,1.41,2095,8.59
64,229.5,388,1.59,2483,10.18
64,226.5,407,1.67,2890,11.85
64,223.5,437,1.79,3327,13.64
64,220.5,476,1.95,3803,15.59
64,217.5,473,1.94,4276,17.53
64,214.5,498,2.04,4774,19.57
64,211.5,525,2.15,5299,21.73
64,208.5,514,2.11,5813,23.83
64,205.5,537,2.2,6350,26.03
64,202.5,508,2.08,6858,28.12
64,199.5,559,2.29,7417,30.41
64,196.5,571,2.34,7988,32.75
64,193.5,532,2.18,8520,34.93
64,190.5,486,1.99,9006,36.92
64,187.5,501,2.05,9507,38.98
64,184.5,538,2.21,10045,41.18
64,181.5,509,2.09,10554,43.27
64,178.5,475,1.95,11029,45.22
64,175.5,472,1.94,11501,47.15
64,172.5,482,1.98,11983,49.13
64,169.5,477,1.96,12460,51.08
64,166.5,456,1.87,12916,52.95
64,163.5,452,1.85,13368,54.81
64,160.5,466,1.91,13834,56.72
64,157.5,420,1.72,14254,58.44
64,154.5,478,1.96,14732,60.4
64,151.5,447,1.83,15179,62.23
64,148.5,404,1.66,15583,63.89
64,145.5,403,1.65,15986,65.54
64,142.5,443,1.82,16429,67.36
64,139.5,418,1.71,16847,69.07
64,136.5,365,1.5,17212,70.57
64,133.5,370,1.52,17582,72.08
64,130.5,344,1.41,17926,73.49
64,127.5,360,1.48,18286,74.97
64,124.5,361,1.48,18647,76.45
64,121.5,319,1.31,18966,77.76
64,118.5,337,1.38,19303,79.14
64,115.5,366,1.5,19669,80.64
64,112.5,345,1.41,20014,82.05
64,109.5,311,1.28,20325,83.33
64,106.5,311,1.28,20636,84.6
64,103.5,286,1.17,20922,85.78
64,100.5,309,1.27,21231,87.04
64,97.5,253,1.04,21484,88.08
64,94.5,250,1.02,21734,89.11
64,91.5,239,0.98,21973,90.09
64,88.5,199,0.82,22172,90.9
64,85.5,171,0.7,22343,91.6
64,82.5,178,0.73,22521,92.33
64,79.5,134,0.55,22655,92.88
64,76.5,138,0.57,22793,93.45
64,73.5,113,0.46,22906,93.91
64,70.5,98,0.4,23004,94.31
64,67.5,73,0.3,23077,94.61
64,64.5,63,0.26,23140,94.87
64,61.5,60,0.25,23200,95.12
64,58.5,33,0.14,23233,95.25
64,55.5,36,0.15,23269,95.4
64,52.5,29,0.12,23298,95.52
64,49.5,20,0.08,23318,95.6
64,46.5,19,0.08,23337,95.68
64,43.5,11,0.05,23348,95.72
64,40.5,9,0.04,23357,95.76
64,37.5,2,0.01,23359,95.77
64,34.5,4,0.02,23363,95.79
64,31.5,6,0.02,23369,95.81
64,28.5,1,0,23370,95.81
64,25.5,2,0.01,23372,95.82
64,22.5,0,0,23372,95.82
64,19.5,1,0,23373,95.83
64,16.5,1,0,23374,95.83
64,13.5,2,0.01,23376,95.84
64,10.5,0,0,23376,95.84
64,7.5,1,0,23377,95.84
64,4.5,0,0,23377,95.84
64,1.5,1014,4.16,24391,100
66,398,0,0,0,0
66,394,0,0,0,0
66,390,0,0,0,0
66,386,0,0,0,0
66,382,0,0,0,0
66,378,1,0.01,1,0.01
66,374,1,0.01,2,0.01
66,370,2,0.01,4,0.03
66,366,0,0,4,0.03
66,362,7,0.05,11,0.07
66,358,13,0.09,24,0.16
66,354,22,0.15,46,0.31
66,350,29,0.19,75,0.5
66,346,64,0.43,139,0.93
66,342,66,0.44,205,1.37
66,338,104,0.69,309,2.06
66,334,142,0.95,451,3.01
66,330,167,1.11,618,4.12
66,326,191,1.27,809,5.39
66,322,218,1.45,1027,6.84
66,318,256,1.71,1283,8.55
66,314,256,1.71,1539,10.26
66,310,277,1.85,1816,12.1
66,306,278,1.85,2094,13.96
66,302,287,1.91,2381,15.87
66,298,283,1.89,2664,17.75
66,294,321,2.14,2985,19.89
66,290,325,2.17,3310,22.06
66,286,322,2.15,3632,24.21
66,282,317,2.11,3949,26.32
66,278,294,1.96,4243,28.28
66,274,278,1.85,4521,30.13
66,270,301,2.01,4822,32.14
66,266,275,1.83,5097,33.97
66,262,319,2.13,5416,36.09
66,258,319,2.13,5735,38.22
66,254,307,2.05,6042,40.27
66,250,277,1.85,6319,42.11
66,246,297,1.98,6616,44.09
66,242,287,1.91,6903,46
66,238,266,1.77,7169,47.78
66,234,310,2.07,7479,49.84
66,230,283,1.89,7762,51.73
66,226,271,1.81,8033,53.54
66,222,286,1.91,8319,55.44
66,218,274,1.83,8593,57.27
66,214,266,1.77,8859,59.04
66,210,244,1.63,9103,60.67
66,206,261,1.74,9364,62.41
66,202,253,1.69,9617,64.09
66,198,242,1.61,9859,65.7
66,194,249,1.66,10108,67.36
66,190,240,1.6,10348,68.96
66,186,228,1.52,10576,70.48
66,182,203,1.35,10779,71.84
66,178,204,1.36,10983,73.2
66,174,214,1.43,11197,74.62
66,170,212,1.41,11409,76.03
66,166,185,1.23,11594,77.27
66,162,193,1.29,11787,78.55
66,158,202,1.35,11989,79.9
66,154,184,1.23,12173,81.13
66,150,198,1.32,12371,82.45
66,146,197,1.31,12568,83.76
66,142,158,1.05,12726,84.81
66,138,146,0.97,12872,85.78
66,134,132,0.88,13004,86.66
66,130,149,0.99,13153,87.66
66,126,166,1.11,13319,88.76
66,122,122,0.81,13441,89.58
66,118,114,0.76,13555,90.34
66,114,104,0.69,13659,91.03
66,110,100,0.67,13759,91.7
66,106,86,0.57,13845,92.27
66,102,71,0.47,13916,92.74
66,98,72,0.48,13988,93.22
66,94,63,0.42,14051,93.64
66,90,45,0.3,14096,93.94
66,86,43,0.29,14139,94.23
66,82,41,0.27,14180,94.5
66,78,37,0.25,14217,94.75
66,74,23,0.15,14240,94.9
66,70,21,0.14,14261,95.04
66,66,17,0.11,14278,95.15
66,62,17,0.11,14295,95.27
66,58,12,0.08,14307,95.35
66,54,7,0.05,14314,95.39
66,50,7,0.05,14321,95.44
66,46,0,0,14321,95.44
66,42,6,0.04,14327,95.48
66,38,3,0.02,14330,95.5
66,34,3,0.02,14333,95.52
66,30,1,0.01,14334,95.53
66,26,5,0.03,14339,95.56
66,22,6,0.04,14345,95.6
66,18,2,0.01,14347,95.61
66,14,0,0,14347,95.61
66,10,0,0,14347,95.61
66,6,0,0,14347,95.61
66,2,658,4.39,15005,100
68,398,0,0,0,0
68,394,0,0,0,0
68,390,0,0,0,0
68,386,0,0,0,0
68,382,0,0,0,0
68,378,1,0,1,0
68,374,2,0.01,3,0.01
68,370,4,0.02,7,0.03
68,366,11,0.05,18,0.08
68,362,11,0.05,29,0.13
68,358,21,0.09,50,0.22
68,354,32,0.14,82,0.37
68,350,51,0.23,133,0.6
68,346,80,0.36,213,0.96
68,342,121,0.54,334,1.5
68,338,149,0.67,483,2.17
68,334,151,0.68,634,2.85
68,330,206,0.93,840,3.78
68,326,223,1,1063,4.78
68,322,252,1.13,1315,5.91
68,318,285,1.28,1600,7.19
68,314,315,1.42,1915,8.61
68,310,369,1.66,2284,10.27
68,306,362,1.63,2646,11.9
68,302,348,1.56,2994,13.46
68,298,399,1.79,3393,15.25
68,294,388,1.74,3781,17
68,290,431,1.94,4212,18.94
68,286,444,2,4656,20.93
68,282,443,1.99,5099,22.92
68,278,426,1.92,5525,24.84
68,274,444,2,5969,26.83
68,270,453,2.04,6422,28.87
68,266,475,2.14,6897,31.01
68,262,441,1.98,7338,32.99
68,258,483,2.17,7821,35.16
68,254,486,2.18,8307,37.34
68,250,434,1.95,8741,39.3
68,246,488,2.19,9229,41.49
68,242,467,2.1,9696,43.59
68,238,422,1.9,10118,45.49
68,234,455,2.05,10573,47.53
68,230,439,1.97,11012,49.51
68,226,440,1.98,11452,51.48
68,222,407,1.83,11859,53.31
68,218,401,1.8,12260,55.12
68,214,379,1.7,12639,56.82
68,210,383,1.72,13022,58.54
68,206,377,1.69,13399,60.24
68,202,371,1.67,13770,61.9
68,198,361,1.62,14131,63.53
68,194,409,1.84,14540,65.37
68,190,364,1.64,14904,67
68,186,334,1.5,15238,68.5
68,182,354,1.59,15592,70.1
68,178,324,1.46,15916,71.55
68,174,324,1.46,16240,73.01
68,170,323,1.45,16563,74.46
68,166,346,1.56,16909,76.02
68,162,304,1.37,17213,77.38
68,158,303,1.36,17516,78.74
68,154,332,1.49,17848,80.24
68,150,282,1.27,18130,81.51
68,146,289,1.3,18419,82.8
68,142,269,1.21,18688,84.01
68,138,289,1.3,18977,85.31
68,134,266,1.2,19243,86.51
68,130,235,1.06,19478,87.57
68,126,227,1.02,19705,88.59
68,122,239,1.07,19944,89.66
68,118,209,0.94,20153,90.6
68,114,176,0.79,20329,91.39
68,110,182,0.82,20511,92.21
68,106,133,0.6,20644,92.81
68,102,124,0.56,20768,93.36
68,98,131,0.59,20899,93.95
68,94,86,0.39,20985,94.34
68,90,84,0.38,21069,94.72
68,86,72,0.32,21141,95.04
68,82,52,0.23,21193,95.28
68,78,49,0.22,21242,95.5
68,74,36,0.16,21278,95.66
68,70,23,0.1,21301,95.76
68,66,23,0.1,21324,95.86
68,62,18,0.08,21342,95.94
68,58,12,0.05,21354,96
68,54,10,0.04,21364,96.04
68,50,6,0.03,21370,96.07
68,46,5,0.02,21375,96.09
68,42,2,0.01,21377,96.1
68,38,6,0.03,21383,96.13
68,34,6,0.03,21389,96.16
68,30,7,0.03,21396,96.19
68,26,7,0.03,21403,96.22
68,22,5,0.02,21408,96.24
68,18,6,0.03,21414,96.27
68,14,3,0.01,21417,96.28
68,10,3,0.01,21420,96.3
68,6,0,0,21420,96.3
68,2,824,3.7,22244,100
69,497.5,0,0,0,0
69,492.5,0,0,0,0
69,487.5,0,0,0,0
69,482.5,0,0,0,0
69,477.5,0,0,0,0
69,472.5,1,0.01,1,0.01
69,467.5,1,0.01,2,0.01
69,462.5,2,0.01,4,0.03
69,457.5,6,0.04,10,0.07
69,452.5,8,0.06,18,0.12
69,447.5,21,0.14,39,0.27
69,442.5,24,0.17,63,0.43
69,437.5,48,0.33,111,0.77
69,432.5,84,0.58,195,1.34
69,427.5,98,0.68,293,2.02
69,422.5,122,0.84,415,2.86
69,417.5,157,1.08,572,3.94
69,412.5,188,1.3,760,5.24
69,407.5,188,1.3,948,6.53
69,402.5,216,1.49,1164,8.02
69,397.5,253,1.74,1417,9.77
69,392.5,263,1.81,1680,11.58
69,387.5,277,1.91,1957,13.49
69,382.5,244,1.68,2201,15.17
69,377.5,259,1.79,2460,16.95
69,372.5,285,1.96,2745,18.92
69,367.5,281,1.94,3026,20.86
69,362.5,320,2.21,3346,23.06
69,357.5,286,1.97,3632,25.03
69,352.5,295,2.03,3927,27.07
69,347.5,252,1.74,4179,28.8
69,342.5,285,1.96,4464,30.77
69,337.5,282,1.94,4746,32.71
69,332.5,304,2.1,5050,34.81
69,327.5,262,1.81,5312,36.61
69,322.5,286,1.97,5598,38.58
69,317.5,289,1.99,5887,40.57
69,312.5,276,1.9,6163,42.48
69,307.5,266,1.83,6429,44.31
69,302.5,298,2.05,6727,46.36
69,297.5,299,2.06,7026,48.43
69,292.5,281,1.94,7307,50.36
69,287.5,249,1.72,7556,52.08
69,282.5,240,1.65,7796,53.73
69,277.5,248,1.71,8044,55.44
69,272.5,248,1.71,8292,57.15
69,267.5,229,1.58,8521,58.73
69,262.5,242,1.67,8763,60.4
69,257.5,249,1.72,9012,62.11
69,252.5,246,1.7,9258,63.81
69,247.5,237,1.63,9495,65.44
69,242.5,224,1.54,9719,66.99
69,237.5,223,1.54,9942,68.52
69,232.5,225,1.55,10167,70.07
69,227.5,199,1.37,10366,71.45
69,222.5,214,1.47,10580,72.92
69,217.5,211,1.45,10791,74.37
69,212.5,188,1.3,10979,75.67
69,207.5,167,1.15,11146,76.82
69,202.5,192,1.32,11338,78.14
69,197.5,190,1.31,11528,79.45
69,192.5,190,1.31,11718,80.76
69,187.5,158,1.09,11876,81.85
69,182.5,175,1.21,12051,83.06
69,177.5,157,1.08,12208,84.14
69,172.5,167,1.15,12375,85.29
69,167.5,156,1.08,12531,86.37
69,162.5,152,1.05,12683,87.41
69,157.5,142,0.98,12825,88.39
69,152.5,128,0.88,12953,89.28
69,147.5,116,0.8,13069,90.08
69,142.5,115,0.79,13184,90.87
69,137.5,120,0.83,13304,91.69
69,132.5,78,0.54,13382,92.23
69,127.5,84,0.58,13466,92.81
69,122.5,73,0.5,13539,93.31
69,117.5,65,0.45,13604,93.76
69,112.5,51,0.35,13655,94.11
69,107.5,46,0.32,13701,94.43
69,102.5,40,0.28,13741,94.71
69,97.5,44,0.3,13785,95.01
69,92.5,29,0.2,13814,95.21
69,87.5,16,0.11,13830,95.32
69,82.5,14,0.1,13844,95.42
69,77.5,18,0.12,13862,95.54
69,72.5,7,0.05,13869,95.59
69,67.5,7,0.05,13876,95.64
69,62.5,7,0.05,13883,95.69
69,57.5,3,0.02,13886,95.71
69,52.5,5,0.03,13891,95.74
69,47.5,3,0.02,13894,95.76
69,42.5,2,0.01,13896,95.78
69,37.5,4,0.03,13900,95.8
69,32.5,4,0.03,13904,95.83
69,27.5,6,0.04,13910,95.87
69,22.5,2,0.01,13912,95.89
69,17.5,2,0.01,13914,95.9
69,12.5,0,0,13914,95.9
69,7.5,1,0.01,13915,95.91
69,2.5,594,4.09,14509,100
70,398,0,0,0,0
70,394,0,0,0,0
70,390,0,0,0,0
70,386,0,0,0,0
70,382,0,0,0,0
70,378,0,0,0,0
70,374,2,0.01,2,0.01
70,370,5,0.02,7,0.03
70,366,3,0.01,10,0.05
70,362,14,0.07,24,0.11
70,358,13,0.06,37,0.18
70,354,14,0.07,51,0.24
70,350,34,0.16,85,0.4
70,346,58,0.28,143,0.68
70,342,63,0.3,206,0.98
70,338,92,0.44,298,1.42
70,334,128,0.61,426,2.03
70,330,142,0.68,568,2.71
70,326,151,0.72,719,3.43
70,322,194,0.92,913,4.35
70,318,232,1.11,1145,5.46
70,314,249,1.19,1394,6.64
70,310,282,1.34,1676,7.99
70,306,289,1.38,1965,9.36
70,302,324,1.54,2289,10.91
70,298,344,1.64,2633,12.55
70,294,341,1.62,2974,14.17
70,290,379,1.81,3353,15.98
70,286,378,1.8,3731,17.78
70,282,381,1.82,4112,19.59
70,278,409,1.95,4521,21.54
70,274,406,1.93,4927,23.48
70,270,450,2.14,5377,25.62
70,266,431,2.05,5808,27.67
70,262,412,1.96,6220,29.64
70,258,415,1.98,6635,31.61
70,254,476,2.27,7111,33.88
70,250,510,2.43,7621,36.31
70,246,452,2.15,8073,38.46
70,242,441,2.1,8514,40.57
70,238,459,2.19,8973,42.75
70,234,467,2.23,9440,44.98
70,230,449,2.14,9889,47.12
70,226,425,2.02,10314,49.14
70,222,439,2.09,10753,51.23
70,218,427,2.03,11180,53.27
70,214,420,2,11600,55.27
70,210,412,1.96,12012,57.23
70,206,410,1.95,12422,59.19
70,202,389,1.85,12811,61.04
70,198,360,1.72,13171,62.75
70,194,384,1.83,13555,64.58
70,190,378,1.8,13933,66.39
70,186,331,1.58,14264,67.96
70,182,342,1.63,14606,69.59
70,178,343,1.63,14949,71.23
70,174,315,1.5,15264,72.73
70,170,310,1.48,15574,74.2
70,166,321,1.53,15895,75.73
70,162,330,1.57,16225,77.31
70,158,320,1.52,16545,78.83
70,154,327,1.56,16872,80.39
70,150,286,1.36,17158,81.75
70,146,312,1.49,17470,83.24
70,142,269,1.28,17739,84.52
70,138,284,1.35,18023,85.87
70,134,259,1.23,18282,87.11
70,130,252,1.2,18534,88.31
70,126,228,1.09,18762,89.39
70,122,186,0.89,18948,90.28
70,118,208,0.99,19156,91.27
70,114,176,0.84,19332,92.11
70,110,135,0.64,19467,92.75
70,106,135,0.64,19602,93.4
70,102,127,0.61,19729,94
70,98,81,0.39,19810,94.39
70,94,74,0.35,19884,94.74
70,90,68,0.32,19952,95.06
70,86,60,0.29,20012,95.35
70,82,39,0.19,20051,95.54
70,78,32,0.15,20083,95.69
70,74,29,0.14,20112,95.83
70,70,20,0.1,20132,95.92
70,66,16,0.08,20148,96
70,62,13,0.06,20161,96.06
70,58,13,0.06,20174,96.12
70,54,13,0.06,20187,96.18
70,50,4,0.02,20191,96.2
70,46,4,0.02,20195,96.22
70,42,3,0.01,20198,96.24
70,38,5,0.02,20203,96.26
70,34,5,0.02,20208,96.28
70,30,7,0.03,20215,96.32
70,26,12,0.06,20227,96.37
70,22,9,0.04,20236,96.42
70,18,7,0.03,20243,96.45
70,14,1,0,20244,96.46
70,10,1,0,20245,96.46
70,6,0,0,20245,96.46
70,2,743,3.54,20988,100
71,497.5,0,0,0,0
71,492.5,0,0,0,0
71,487.5,0,0,0,0
71,482.5,0,0,0,0
71,477.5,0,0,0,0
71,472.5,0,0,0,0
71,467.5,0,0,0,0
71,462.5,2,0.02,2,0.02
71,457.5,8,0.06,10,0.08
71,452.5,5,0.04,15,0.12
71,447.5,9,0.07,24,0.18
71,442.5,15,0.12,39,0.3
71,437.5,29,0.22,68,0.52
71,432.5,50,0.39,118,0.91
71,427.5,71,0.55,189,1.46
71,422.5,87,0.67,276,2.13
71,417.5,109,0.84,385,2.97
71,412.5,117,0.9,502,3.87
71,407.5,157,1.21,659,5.08
71,402.5,184,1.42,843,6.5
71,397.5,197,1.52,1040,8.02
71,392.5,209,1.61,1249,9.63
71,387.5,207,1.6,1456,11.22
71,382.5,253,1.95,1709,13.17
71,377.5,214,1.65,1923,14.82
71,372.5,261,2.01,2184,16.83
71,367.5,255,1.97,2439,18.8
71,362.5,224,1.73,2663,20.52
71,357.5,279,2.15,2942,22.67
71,352.5,260,2,3202,24.68
71,347.5,266,2.05,3468,26.73
71,342.5,242,1.87,3710,28.59
71,337.5,283,2.18,3993,30.77
71,332.5,232,1.79,4225,32.56
71,327.5,267,2.06,4492,34.62
71,322.5,252,1.94,4744,36.56
71,317.5,281,2.17,5025,38.73
71,312.5,281,2.17,5306,40.89
71,307.5,262,2.02,5568,42.91
71,302.5,238,1.83,5806,44.75
71,297.5,260,2,6066,46.75
71,292.5,280,2.16,6346,48.91
71,287.5,275,2.12,6621,51.03
71,282.5,239,1.84,6860,52.87
71,277.5,260,2,7120,54.87
71,272.5,232,1.79,7352,56.66
71,267.5,230,1.77,7582,58.44
71,262.5,224,1.73,7806,60.16
71,257.5,231,1.78,8037,61.94
71,252.5,226,1.74,8263,63.68
71,247.5,202,1.56,8465,65.24
71,242.5,245,1.89,8710,67.13
71,237.5,207,1.6,8917,68.72
71,232.5,207,1.6,9124,70.32
71,227.5,202,1.56,9326,71.88
71,222.5,185,1.43,9511,73.3
71,217.5,178,1.37,9689,74.67
71,212.5,158,1.22,9847,75.89
71,207.5,175,1.35,10022,77.24
71,202.5,166,1.28,10188,78.52
71,197.5,180,1.39,10368,79.91
71,192.5,154,1.19,10522,81.09
71,187.5,176,1.36,10698,82.45
71,182.5,167,1.29,10865,83.74
71,177.5,172,1.33,11037,85.06
71,172.5,156,1.2,11193,86.27
71,167.5,148,1.14,11341,87.41
71,162.5,109,0.84,11450,88.25
71,157.5,114,0.88,11564,89.13
71,152.5,111,0.86,11675,89.98
71,147.5,111,0.86,11786,90.84
71,142.5,85,0.66,11871,91.49
71,137.5,85,0.66,11956,92.15
71,132.5,74,0.57,12030,92.72
71,127.5,63,0.49,12093,93.2
71,122.5,62,0.48,12155,93.68
71,117.5,48,0.37,12203,94.05
71,112.5,38,0.29,12241,94.34
71,107.5,39,0.3,12280,94.64
71,102.5,42,0.32,12322,94.97
71,97.5,25,0.19,12347,95.16
71,92.5,19,0.15,12366,95.31
71,87.5,16,0.12,12382,95.43
71,82.5,12,0.09,12394,95.52
71,77.5,18,0.14,12412,95.66
71,72.5,6,0.05,12418,95.71
71,67.5,10,0.08,12428,95.78
71,62.5,6,0.05,12434,95.83
71,57.5,4,0.03,12438,95.86
71,52.5,8,0.06,12446,95.92
71,47.5,5,0.04,12451,95.96
71,42.5,1,0.01,12452,95.97
71,37.5,3,0.02,12455,95.99
71,32.5,2,0.02,12457,96.01
71,27.5,3,0.02,12460,96.03
71,22.5,1,0.01,12461,96.04
71,17.5,1,0.01,12462,96.05
71,12.5,1,0.01,12463,96.05
71,7.5,1,0.01,12464,96.06
71,2.5,511,3.94,12975,100
72,497.5,0,0,0,0
72,492.5,0,0,0,0
72,487.5,0,0,0,0
72,482.5,0,0,0,0
72,477.5,0,0,0,0
72,472.5,0,0,0,0
72,467.5,4,0.02,4,0.02
72,462.5,4,0.02,8,0.04
72,457.5,8,0.04,16,0.08
72,452.5,12,0.06,28,0.14
72,447.5,21,0.1,49,0.24
72,442.5,21,0.1,70,0.34
72,437.5,49,0.24,119,0.58
72,432.5,65,0.32,184,0.89
72,427.5,98,0.48,282,1.37
72,422.5,141,0.68,423,2.05
72,417.5,135,0.66,558,2.71
72,412.5,163,0.79,721,3.5
72,407.5,192,0.93,913,4.43
72,402.5,197,0.96,1110,5.39
72,397.5,243,1.18,1353,6.57
72,392.5,284,1.38,1637,7.95
72,387.5,288,1.4,1925,9.35
72,382.5,318,1.54,2243,10.89
72,377.5,304,1.48,2547,12.37
72,372.5,297,1.44,2844,13.81
72,367.5,390,1.89,3234,15.7
72,362.5,361,1.75,3595,17.45
72,357.5,363,1.76,3958,19.22
72,352.5,383,1.86,4341,21.07
72,347.5,373,1.81,4714,22.89
72,342.5,406,1.97,5120,24.86
72,337.5,408,1.98,5528,26.84
72,332.5,395,1.92,5923,28.76
72,327.5,445,2.16,6368,30.92
72,322.5,434,2.11,6802,33.02
72,317.5,433,2.1,7235,35.12
72,312.5,400,1.94,7635,37.07
72,307.5,408,1.98,8043,39.05
72,302.5,438,2.13,8481,41.17
72,297.5,456,2.21,8937,43.39
72,292.5,427,2.07,9364,45.46
72,287.5,414,2.01,9778,47.47
72,282.5,424,2.06,10202,49.53
72,277.5,429,2.08,10631,51.61
72,272.5,372,1.81,11003,53.42
72,267.5,379,1.84,11382,55.26
72,262.5,354,1.72,11736,56.98
72,257.5,360,1.75,12096,58.72
72,252.5,382,1.85,12478,60.58
72,247.5,361,1.75,12839,62.33
72,242.5,332,1.61,13171,63.94
72,237.5,345,1.67,13516,65.62
72,232.5,333,1.62,13849,67.23
72,227.5,348,1.69,14197,68.92
72,222.5,310,1.51,14507,70.43
72,217.5,306,1.49,14813,71.91
72,212.5,300,1.46,15113,73.37
72,207.5,311,1.51,15424,74.88
72,202.5,311,1.51,15735,76.39
72,197.5,310,1.51,16045,77.9
72,192.5,320,1.55,16365,79.45
72,187.5,286,1.39,16651,80.84
72,182.5,289,1.4,16940,82.24
72,177.5,280,1.36,17220,83.6
72,172.5,290,1.41,17510,85.01
72,167.5,259,1.26,17769,86.27
72,162.5,238,1.16,18007,87.42
72,157.5,240,1.17,18247,88.59
72,152.5,220,1.07,18467,89.65
72,147.5,198,0.96,18665,90.62
72,142.5,174,0.84,18839,91.46
72,137.5,168,0.82,19007,92.28
72,132.5,146,0.71,19153,92.98
72,127.5,119,0.58,19272,93.56
72,122.5,116,0.56,19388,94.13
72,117.5,92,0.45,19480,94.57
72,112.5,74,0.36,19554,94.93
72,107.5,77,0.37,19631,95.31
72,102.5,52,0.25,19683,95.56
72,97.5,29,0.14,19712,95.7
72,92.5,34,0.17,19746,95.86
72,87.5,21,0.1,19767,95.97
72,82.5,14,0.07,19781,96.03
72,77.5,19,0.09,19800,96.13
72,72.5,17,0.08,19817,96.21
72,67.5,11,0.05,19828,96.26
72,62.5,8,0.04,19836,96.3
72,57.5,3,0.01,19839,96.32
72,52.5,8,0.04,19847,96.35
72,47.5,5,0.02,19852,96.38
72,42.5,6,0.03,19858,96.41
72,37.5,2,0.01,19860,96.42
72,32.5,5,0.02,19865,96.44
72,27.5,3,0.01,19868,96.46
72,22.5,5,0.02,19873,96.48
72,17.5,1,0,19874,96.49
72,12.5,0,0,19874,96.49
72,7.5,0,0,19874,96.49
72,2.5,724,3.51,20598,100
